# MacOSX10.5Cangjie-Arthurmcarthur20200719
# Arthurmcarthur提取，碼表有好多年了，注意差異，比如缺乏三代編碼，無簡化字。
一	m
═	m
二	mm
三	mmm
㠭	mmmm
頙	mmmbc
頸	mmmbc
琧	mmmgi
辰	mmmv
云	mmi
厔	mmig
丽	mmbib
丽	mmbb
婯	mmbbv
麗	mmbbp
項	mmbc
亍	mmn
邳	mmnl
堊	mmg
勁	mmks
亓	mml
蝁	mmlmi
刯	mmln
剄	mmln
厉	mms
靕	mmqmb
巰	mmyiu
虣	mmypu
示	mmf
元	mmu
坖	mmug
厦	mmue
黿	mmuu
瓨	mmvn
亏	mmvs
巧	mmvs
厊	mmvh
政	mmok
忈	mmp
悪	mmp
惡	mmp
𢘫	mmp
吾	mmr
鵛	mmha
鵛	mmhaf
鴊	mmhaf
鵡	mmhaf
鵶	mmhaf
厨	mmti
𤤴	mimgi
晉	miia
靉	mibbe
鄏	minl
至	mig
动	miks
靅	milnc
霴	mile
靆	miyle
厖	miuh
霒	mioin
霼	miond
霕	mipu
𤤙	mipt
𠩯	mihl
魂	mihui
䲰	mihaf
䴇	mihaf
𤩺	mitgi
亙	mbm
雲	mbmmi
雩	mbmms
震	mbmmv
霊	mbmmc
𩃬	mbmin
需	mbmbl
顬	mbmbc
璽	mbmgi
𩁹	mbmd
雼	mbmr
靂	mbmhm
戞	mbi
䨏	mbimo
鬴	mbijb
霡	mbbme
霥	mbbmo
霡	mbbie
霌	mbbgr
覼	mbbuu
𧢝	mbbuu
霾	mbbhg
霢	mbbhv
霱	mbnib
雺	mbnih
霛	mbnnn
𩃀	mbnkm
霆	mbnkg
邴	mbnl
霳	mbnlm
𩄐	mbnlq
䬠	mbnoo
霯	mbnot
霱	mbnhb
霚	mbnhk
雭	mbnhe
霧	mbnhs
霿	mbnhu
壐	mbg
耎	mbk
𩃤	mbkmr
勵	mbks
雬	mbd
耐	mbdi
霜	mbdbu
霖	mbdd
霦	mbddh
𩃭	mbdci
融	mblmi
蠒	mblmi
霏	mblmy
雿	mblmo
雵	mblbk
而	mbll
雷	mbw
靁	mbwww
電	mbwu
霬	mbwtc
靋	mbemm
䨵	mbemj
霪	mbebg
霘	mbebr
霐	mbeni
霂	mbed
𩄼	mbely
霃	mbelu
霈	mbejb
霔	mbeyg
霶	mbeys
霑	mbeyr
霗	mbeoi
霮	mbetv
霟	mbetc
雪	mbsm
翮	mbsmm
𠻸	mbsmr
霫	mbsma
霨	mbsfi
霹	mbsrj
霋	mbjlv
䨝	mbqmb
霅	mbymr
靇	mbybp
雯	mbyk
霩	mbydl
䨤	mbylw
霽	mbyx
靄	mbyrv
雱	mbyhs
𩅛	mbyhj
𩂱	mbyhv
雴	mbyt
霠	mbytn
霎	mbytv
霄	mbfb
頁	mbuc
貢	mbuc
鬷	mbuce
耍	mbv
𩂰	mbvr
页	mbo
零	mboii
霍	mbog
靃	mbogg
𩂯	mbod
霉	mbowy
鬺	mboah
𩃥	mbohb
恧	mbp
𩂈	mbp
雹	mbpru
憂	mbphe
厠	mbcn
雰	mbcsh
𠫍	mbcc
𩆨	mbchj
露	mbrmr
霣	mbrbc
霞	mbrse
霵	mbrji
𩆜	mbrri
𤫊	mbrrg
孁	mbrrv
靈	mbrro
龗	mbrrp
霝	mbrrr
𩅍	mbawe
霷	mbaah
𩂋	mbhml
𩄍	mbhdf
𩂓	mbhey
雮	mbhqu
雽	mbhfd
霺	mbhok
霓	mbhxu
鳾	mbhaf
鷊	mbhaf
鸖	mbhaf
鸍	mbhaf
鴯	mbhaf
霤	mbhhw
鬸	mbhhw
耏	mbhhh
雸	mbtm
霰	mbtbk
靀	mbtbo
霥	mbtbo
霙	mbtlk
霸	mbtjb
覇	mbtjb
覊	mbtjf
覉	mbtjr
𩅰	mbtcl
丁	mn
頂	mnmbc
殭	mnmwm
甅	mnmwg
殛	mnmem
殌	mnmvm
瓸	mnma
歹	mni
殘	mnii
殏	mnije
残	mniq
殆	mnir
殂	mnbm
殍	mnbnd
邒	mnnl
邷	mnnl
鮤	mnnwf
歿	mnne
型	mng
殪	mngbt
殰	mngwc
𣧂	mnk
殗	mnklu
殎	mnkoo
殢	mnkpb
殐	mndl
邛	mnl
蛩	mnlmi
殃	mnlbk
列	mnln
殔	mnle
肂	mnlq
殟	mnwot
瓧	mnj
殯	mnjmc
殥	mnjmc
殖	mnjbm
殑	mnjru
殡	mnjhc
㧬	mnq
殧	mnyfu
裂	mnyhv
殕	mnytr
烈	mnf
烮	mnf
姴	mnv
飱	mnomv
殮	mnomo
殲	mnoim
飱	mnoiv
殤	mnoah
殄	mnohh
死	mnp
𢢭	mnp
恐	mnp
瓲	mnpu
殉	mnpa
歾	mnphh
殜	mnptd
銎	mnc
銐	mnc
瓰	mncsh
可	mnr
殞	mnrbc
跫	mnryo
殫	mnrrj
殈	mnhbt
殁	mnhne
殀	mnhk
殊	mnhjd
瓱	mnhqu
殠	mnhuk
殙	mnhpa
鴷	mnha
鴷	mnhaf
殦	mnhaf
殣	mntlm
鞏	mntlj
王	mg
𤣩	mg
玒	mgm
玩	mgmmu
𤫟	mgmmp
珸	mgmmr
臸	mgmig
瑨	mgmia
𤫩	mgmbm
瓀	mgmbb
瑌	mgmbk
瓇	mgmbe
𤫑	mgmbe
頊	mgmbc
𤫢	mgmbr
玎	mgmn
珂	mgmnr
玨	mgmg
珏	mgmgi
璱	mgmgh
玗	mgmd
瓑	mgmdm
𤦩	mgmlm
璢	mgmlw
瑮	mgmwd
㻼	mgmwj
𤨧	mgmwf
琢	mgmso
玕	mgmj
环	mgmf
𦤹	mgmf
玶	mgmfj
𤧶	mgmue
珁	mgmvn
甄	mgmvn
玡	mgmvh
珷	mgmpm
𤤿	mgma
琊	mgmhl
𤣿	mgmt
𤪲	mgmtb
㺨	mgi
压	mgi
玉	mgi
玊	mgi
琖	mgii
𤨡	mgiib
瑯	mgiil
𤧻	mging
𤤯	mgine
班	mgilg
瑭	mgilr
㻞	mgisb
璷	mgisk
球	mgije
㻐	mgice
珆	mgir
琙	mgirm
琅	mgiav
珬	mgihm
珹	mgihs
臹	mgihs
臹	mgihs
玧	mgihu
瑊	mgihr
再	mgb
玥	mgb
珇	mgbm
瑗	mgbme
㻚	mgbb
珊	mgbbm
璦	mgbbe
𤩥	mgbbq
琈	mgbnd
琱	mgbgr
琤	mgbsd
琿	mgbjj
玬	mgby
現	mgbuu
珼	mgbuc
贋	mgbuc
瑤	mgbou
瑶	mgbou
琛	mgbcd
瓔	mgbcv
𤤌	mgbhn
瑫	mgbhx
珊	mgbt
𤥀	mgnin
𤥁	mgnir
瑍	mgnbk
瓊	mgnbe
𤥻	mgnkm
珽	mgnkg
𤧣	mgnkq
㺭	mgnd
郅	mgnl
鄄	mgnl
瓍	mgnlb
𤣻	mgne
𤣲	mgnj
㻧	mgnqd
珎	mgnf
玖	mgno
歅	mgno
璒	mgnot
㻊	mgnau
璚	mgnhb
瑈	mgnhd
厓	mgg
𤣰	mgg
珐	mggi
珃	mggb
璹	mggni
瓙	mggnf
珪	mggg
𤩊	mgggu
瓄	mggwc
璈	mggsk
𤥴	mggp
𤦫	mggce
琦	mgkmr
珛	mgkb
琋	mgkkb
珔	mgkld
臶	mgkld
玏	mgks
珕	mgkss
珈	mgksr
𤥵	mgkoo
璙	mgkcf
𤨦	mgkhr
琹	mgd
瑋	mgdmq
玦	mgdk
琳	mgdd
璴	mgddo
瓎	mgdlc
瑓	mgdwf
琹	mgdoo
琜	mgdoo
玻	mgdhe
琲	mglmy
珧	mglmo
璝	mglmc
璶	mglmt
到	mgln
𤤖	mglln
玔	mglll
璛	mglll
珅	mglwl
㻖	mgle
珒	mglq
璛	mglx
理	mgwg
珚	mgwk
𤨒	mgwkp
玾	mgwl
㻿	mgwli
環	mgwlv
瓃	mgwww
瑻	mgwjc
琾	mgwol
瑥	mgwot
㻫	mgwtj
𤤾	mgemn
瑵	mgeii
琺	mgegi
璖	mgesd
𤦊	mgea
珝	mgsmm
璕	mgsmi
璻	mgsmj
璆	mgsmh
璼	mgsmt
厫	mgsk
珺	mgskr
㺿	mgsll
珥	mgsj
瑘	mgsjl
琚	mgsjr
𤥶	mgsql
瑪	mgsqf
玘	mgsu
𤣱	mgsu
𤤗	mgsp
玿	mgshr
𤧷	mgstv
𤧅	mgstt
瑄	mgjmm
琮	mgjmf
𤩷	mgjmu
琔	mgjmo
𤨎	mgjmo
璌	mgjmc
璸	mgjmc
瑼	mgjii
璤	mgjip
𤦌	mgjbm
瑱	mgjbc
琬	mgjnu
珯	mgjkp
𤨥	mgjkr
琽	mgjka
𤪓	mgjyu
𤥃	mgjv
𤪥	mgjpn
瑢	mgjcr
瑏	mgjch
瑚	mgjrb
𤥣	mgjru
琯	mgjrr
𤪺	mgjhw
𤦭	mgqmb
瑇	mgqmw
瑇	mgqmy
瑧	mgqkd
臻	mgqkd
琫	mgqkq
瑃	mgqka
玤	mgqj
㻰	mgqjm
𤪳	mgqjp
玞	mgqo
瓉	mgqoc
𤩦	mgqhf
㺪	mgy
玼	mgymp
琂	mgymr
珫	mgyi
珫	mgyiu
琉	mgyiu
瓛	mgybk
𤧭	mgybs
璭	mgybj
璿	mgybu
𤪻	mgybu
瓏	mgybp
𤦹	mgybc
𤩅	mgybr
㼀	mgygq
玟	mgyk
斑	mgykg
珳	mgykh
𤥂	mgylc
璮	mgywm
瓌	mgywv
璨	mgyed
𤨪	mgyed
㻢	mgysd
璇	mgyso
璉	mgyjj
玣	mgyy
瓋	mgyyb
琡	mgyfe
璃	mgyub
玹	mgyvi
璡	mgyog
𤥿	mgyok
琗	mgyoj
琥	mgypu
璩	mgypo
瓐	mgypt
璾	mgyx
珓	mgyck
玷	mgyr
𤧟	mgyrn
琼	mgyrf
𤦻	mgyru
瓖	mgyrv
琸	mgyaj
𤤁	mgyhs
璋	mgytj
璄	mgytu
璲	mgyto
琣	mgytr
𤦺	mgytr
珖	mgfmu
琑	mgfb
瑺	mgfbb
璫	mgfbw
瑣	mgfbc
璘	mgfdq
𤦔	mgfqu
琰	mgff
㼆	mgffg
𤪤	mgffd
𤩂	mgffs
玌	mgu
瑞	mgumb
𤧸	mgumt
𤪖	mgufk
瓗	mguob
琌	mguon
璀	mguog
㼇	mguos
𤨾	mguap
𤩑	mgutn
璣	mgvii
瓅	mgvid
㼄	mgviw
𤤳	mgvio
琭	mgvne
瑑	mgvno
㺩	mgvl
璅	mgvvd
瑙	mgvvw
珡	mgo
𤦎	mgomb
瑜	mgomn
㻇	mgomg
㻌	mgomd
珨	mgomr
璯	mgoma
琀	mgoi
玲	mgoii
玪	mgoin
琴	mgoin
玳	mgoip
𤦬	mgoip
琀	mgoir
瑲	mgoir
琁	mgono
琟	mgog
玫	mgok
致	mgok
玠	mgoll
珻	mgowy
玝	mgoj
珡	mgoju
珤	mgoju
𤨨	mgoyk
𤦸	mgord
𤦍	mgohb
珍	mgohh
𤪕	mgotq
玓	mgpi
𤪦	mgpko
𤧚	mgpkp
𤤀	mgpu
琵	mgpp
玭	mgpp
瑎	mgppa
玽	mgpr
玸	mgpru
珣	mgpa
瑟	mgph
珌	mgph
𤦏	mgphp
玴	mgpt
㻡	mgptd
兲	mgc
𨨖	mgc
玜	mgci
珶	mgcnh
璔	mgcwa
玢	mgcsh
璐	mgrmr
琄	mgrb
瑕	mgrse
珿	mgryo
珉	mgrvp
瑉	mgrpa
噩	mgrr
璪	mgrrd
𤩧	mgrrj
珵	mgrhg
瑅	mgamo
瑒	mgamh
瑁	mgabu
瑥	mgabt
瓓	mganw
𤩎	mgana
㻴	mgawe
琝	mgayk
璟	mgayf
琶	mgau
珢	mgav
琨	mgapp
㻛	mgaph
琩	mgaa
瑆	mgahm
瑂	mgahu
瑰	mghi
珘	mghby
珦	mghbr
珮	mghnb
珟	mghnn
𤪧	mghnf
珗	mghgu
𤥢	mghgr
𤩝	mghkb
琍	mghdn
𤩏	mghdg
㻑	mghdd
𤦋	mghdl
璠	mghdw
琇	mghds
𤧐	mghdf
璳	mghdc
瑀	mghlb
璁	mghwp
琒	mghej
珞	mgher
璬	mghsk
𤣳	mghj
珠	mghjd
瑖	mghje
𤪔	mghjr
珄	mghqm
珴	mghqi
瑰	mghui
瓚	mghuc
珩	mghon
𤦷	mghon
瑽	mghoo
𤨤	mghoh
𤪱	mghoh
琘	mghpa
𤦤	mghxu
璵	mghxc
瑡	mghrb
瑦	mghrf
珀	mgha
瑝	mghag
瑔	mghae
鵄	mghaf
𪆒	mghaf
鳿	mghaf
珋	mghhl
瑠	mghhw
瓈	mghhe
琕	mghhj
弄	mgt
玵	mgtm
璍	mgtmj
琪	mgtmc
㕑	mgti
𤦧	mgtio
瑐	mgtbn
琠	mgtbc
𤩸	mgtnk
𤧞	mgtgk
琷	mgtgu
瓂	mgtgt
瑾	mgtlm
璊	mgtlb
瑛	mgtlk
𤫇	mgtlf
𤨢	mgtlo
璜	mgtlc
𤨕	mgtjs
珜	mgtq
瑳	mgtqm
𤨩	mgtqg
𤪼	mgtyj
𤧹	mgtvi
瑹	mgtod
𤨓	mgtod
瓁	mgtoe
㻩	mgtxc
珙	mgtc
璂	mgtcg
𤩐	mgtcl
𤪌	mgtcf
璞	mgtco
𤦈	mgtch
瓘	mgtrg
璥	mgtrk
㻳	mgthn
璓	mgths
㻂	mgtt
天	mk
靨	mkmwl
郠	mknl
壓	mkg
𡍶	mkg
檿	mkd
𥀬	mkdhe
蝅	mklmi
黶	mkwgf
厴	mkwl
沗	mke
功	mks
历	mks
擪	mkq
无	mku
嬮	mkv
饏	mkomv
饜	mkoiv
憨	mkp
奣	mkab
甦	mkhqm
魘	mkhui
鴌	mkhaf
于	md
五	mdm
㻺	mdmgi
磿	mdmr
厢	mdbu
盂	mdbt
邘	mdnl
歴	mddm
𠪴	mddo
暦	mdda
歴	mdylm
㷴	mdf
𢟍	mdp
鷅	mdhaf
丅	ml
丌	ml
工	mlm
厞	mlmy
帀	mlb
⻗	mlby
雨	mlby
両	mlbu
兩	mlbo
亜	mllm
亞	mllm
畱	mllw
覀	mllw
更	mlwk
丏	mlvs
畺	mwmm
票	mwmmf
釃	mwmmp
醹	mwmbb
醽	mwmbr
酊	mwmn
酠	mwmnr
酑	mwmd
靐	mwmww
醰	mwmwj
醥	mwmwf
酐	mwmj
醆	mwii
䣭	mwik
𨠄	mwiku
醾	mwidd
釄	mwidy
酬	mwill
醣	mwilr
酺	mwijb
釄	mwijy
醿	mwijf
酸	mwice
醎	mwihr
酮	mwbmr
酻	mwbnd
酹	mwbdi
釂	mwbwi
靦	mwbuu
賈	mwbuc
酩	mwnir
醑	mwnob
䤆	mwnok
醱	mwnoe
厘	mwg
垔	mwg
醻	mwgni
㕓	mwgg
酞	mwki
酔	mwknj
醃	mwklu
勔	mwks
𠡳	mwks
醢	mwkrt
栗	mwd
酎	mwdi
醂	mwdd
靧	mwlmc
蠠	mwlii
酖	mwlbu
副	mwln
醠	mwlkt
醓	mwlut
醳	mwwlj
醞	mwwot
醊	mweee
䣳	mwsmr
醪	mwsmh
面	mwsl
配	mwsu
醧	mwsrr
酵	mwjkd
醏	mwjka
酧	mwjdi
酡	mwjp
醡	mwjcs
酤	mwjr
醐	mwjrb
酜	mwqo
酼	mwyiu
酼	mwyiv
醯	mwyit
酙	mwyj
醚	mwyfd
醨	mwyub
醯	mwyut
醉	mwyoj
醵	mwypo
酟	mwyr
醇	mwyrd
釀	mwyrv
醕	mwyra
醷	mwytp
醅	mwytr
粟	mwfd
醈	mwff
酗	mwuk
要	mwv
酳	mwvib
醁	mwvne
酫	mwomg
酴	mwomd
醶	mwomo
醀	mwog
醮	mwogf
酶	mwowy
酶	mwoey
酢	mwos
酌	mwpi
酏	mwpd
醄	mwpou
靤	mwpru
酯	mwpa
酚	mwcsh
靣	mwr
䣺	mwrb
釅	mwrrk
酲	mwrhg
醍	mwamo
醖	mwabt
覃	mwaj
醌	mwapp
醒	mwahm
醜	mwhi
覂	mwhio
酘	mwhne
醺	mwhgf
酰	mwhgu
酷	mwhgr
酥	mwhd
酪	mwher
覈	mwhsk
酕	mwhqu
醜	mwhui
覆	mwhoe
醙	mwhxe
鶝	mwhaf
酣	mwtm
䤑	mwtmc
醼	mwtlf
醲	mwtwv
醩	mwtwa
醴	mwtwt
覇	mwtjb
覊	mwtjf
覉	mwtjr
醝	mwtqm
醛	mwtog
醭	mwtco
醋	mwta
汞	me
亟	mem
鄾	menl
𨫣	mec
唘	mer
万	ms
戸	ms
鄠	msnl
豖	msko
卭	msl
厄	msu
𠩐	msv
攷	msok
𩅞	mshjg
豕	msho
干	mj
頇	mjmbc
幵	mjmj
郉	mjmjl
麉	mjixp
厧	mjbc
𢏗	mjn
邗	mjnl
栞	mjd
刊	mjln
厙	mjwj
聼	mjjwp
烎	mjf
敢	mjok
鷣	mjha
鷣	mjhaf
鳱	mjhaf
下	my
龎	mybp
正	mylm
焉	mylf
丐	myvs
𤴓	myo
忑	myp
𠫂	mypt
厗	mytj
不	mf
𣎴	mf
丕	mfm
祘	mfmmf
顠	mfmb
顠	mfmbc
願	mfmbc
嫑	mfmwv
歪	mfmym
厰	mfbk
爾	mfbk
甭	mfbq
覔	mfbuu
覝	mfbuu
盃	mfbt
鄢	mfnl
奀	mfk
勡	mfks
剽	mfln
翲	mfsmm
平	mfj
𠁆	mfjbm
𥜆	mfyiu
孬	mfvnd
𠀾	mfomi
愿	mfp
否	mfr
𧶏	mfrbc
飄	mfhni
瓢	mfhvo
鴀	mfhaf
彯	mfhhh
兀	mu
兀	mu
頋	mumbc
頑	mumbc
尫	mumg
豗	mumso
鬵	mumrb
戛	mui
両	mub
襾	mub
卼	munmu
邧	munl
奡	mukll
虺	mulmi
刓	muln
画	muw
𦒘	musmm
尶	musmt
炁	muf
𣿅	muf
朁	mua
蠶	muali
夏	muhe
䲮	muhaf
鸘	muhaf
匚	mv
匸	mv
脣	mvb
互	mvnm
瓦	mvni
旡	mvku
辱	mvdi
牙	mvdh
蜃	mvlmi
巠	mvvm
覅	mvphh
唇	mvr
仄	mo
豩	momso
豣	momjj
厱	momo
豲	momhf
豜	momt
豧	moijb
丙	mob
豠	mobm
覡	mobuu
豯	mobvk
豷	mogbt
㷳	mogf
贋	mogc
攻	mok
豨	mokkb
橜	mod
蟨	molmi
蟸	molii
劂	moln
剢	moln
䝏	molwv
豱	mowot
厏	mos
豬	mojka
厒	moju
豶	mojtc
豥	moyvo
豴	moycb
燹	mof
贗	mofc
䝎	moumb
巫	moo
𧱬	moomn
两	moob
雁	moog
𢽴	mook
豘	mopu
豞	mopr
豭	morse
蹷	moryo
豝	moau
豤	moav
豛	mohne
豟	mohsn
甤	mohqm
鴈	mohf
豵	mohoo
鵐	mohaf
鷢	mohaf
貮	mpbuc
酈	mpnl
武	mpylm
鸝	mphaf
彲	mphhh
顨	mcml
西	mcw
酉	mcwm
慐	mcp
𢥧	mcp
𢦀	mcp
晋	mca
夒	mche
㹕	mchq
顨	mct
石	mr
矼	mrm
𥐯	mrmmi
礝	mrmbb
礭	mrmbg
礌	mrmbw
𥗠	mrmbs
礵	mrmbu
碩	mrmbc
頢	mrmbc
矴	mrmn
砢	mrmnr
砡	mrmgi
硦	mrmgt
硬	mrmlk
礓	mrmwm
磹	mrmwj
砈	mrmsu
硺	mrmso
矸	mrmj
硏	mrmjj
砰	mrmfj
矹	mrmu
硜	mrmvm
磭	mrmvb
砑	mrmvh
碔	mrmpm
硒	mrmcw
砳	mrmr
磊	mrmrr
舙	mrmrr
礰	mrmhm
研	mrmt
礪	mrmtb
硎	mrmtn
戨	mri
碊	mrii
磣	mriih
磗	mribi
䃺	mridy
礳	mridr
磄	mrilr
砯	mrie
𥔱	mrism
硥	mriuh
硠	mriav
磩	mrihf
碱	mrihr
礦	mritc
砠	mrbm
硐	mrbmr
硼	mrbb
𥑬	mrbbm
磆	mrbbb
碢	mrbbr
碉	mrbgr
鬲	mrbl
碀	mrbsd
鞷	mrbj
砽	mrbq
砃	mrby
硯	mrbuu
𧵔	mrbuc
磎	mrbvk
磜	mrbof
磘	mrbou
𥔿	mrbhx
碙	mrbtu
硊	mrnmu
矽	mrni
确	mrnbg
硟	mrnkm
矷	mrnd
郚	mrnl
酃	mrnl
磔	mrnqd
歌	mrno
砍	mrno
磴	mrnot
舚	mrncr
哥	mrnr
砐	mrnhe
砝	mrgi
磕	mrgit
硅	mrgg
磽	mrggu
磝	mrgsk
碐	mrgce
硈	mrgr
礂	mrgrr
碕	mrkmr
砕	mrknj
磢	mrkkk
硽	mrklv
𥑆	mrksr
硤	mrkoo
砵	mrdm
砄	mrdk
碄	mrdd
礎	mrddo
砞	mrdj
硹	mrdci
碴	mrdam
破	mrdhe
矵	mrln
砩	mrlln
砷	mrlwl
硉	mrlq
畐	mrw
碨	mrwmv
硱	mrwd
礋	mrwlj
礧	mrwww
砪	mrwyi
𥖏	mrwyc
磥	mrwvf
碅	mrwhd
砅	mre
泵	mre
磉	mreed
磲	mresd
䂿	mrea
䂻	mrsmv
磖	mrsma
磟	mrsmh
礛	mrsit
𥐰	mrsk
砸	mrslb
䃘	mrseg
礥	mrsec
碼	mrsqf
礮	mrsfk
礔	mrsrj
𥕥	mrsrr
碾	mrstv
碹	mrjmm
碂	mrjmf
碇	mrjmo
礗	mrjmc
磚	mrjii
磌	mrjbc
碗	mrjnu
硣	mrjkd
硓	mrjkp
硨	mrjwj
磍	mrjqr
砣	mrjp
硿	mrjcm
𥑮	mrjr
碦	mrjhr
碃	mrqmb
碡	mrqmy
磧	mrqmc
砆	mrqo
碶	mrqhk
硫	mryiu
碲	mrybb
磅	mrybs
礲	mrybp
砫	mryg
砇	mryk
礅	mrydk
砋	mrylm
磠	mrywi
硋	mryvo
碎	mryoj
𥕦	mrycv
砧	mryr
碻	mryrb
碠	mryrn
砊	mryhn
磓	mryhr
砬	mryt
𥕞	mrytj
磀	mrytu
礈	mryto
碚	mrytr
硄	mrfmu
硝	mrfb
礑	mrfbw
磷	mrfdq
𥕝	mrfdr
磱	mrffs
礯	mrfff
砂	mrfh
硸	mrumj
碳	mrumf
碋	mrumr
磑	mrumt
磞	mrubb
磮	mruob
硶	mruon
磪	mruog
磯	mrvii
礫	mrvid
碌	mrvne
碯	mrvvw
砼	mrom
碖	mromb
硂	mromg
硢	mromd
礆	mromo
硆	mromr
䃸	mroim
砱	mroii
確	mrobg
矻	mron
碓	mrog
磼	mrogd
礁	mrogf
敔	mrok
砎	mroll
砟	mros
砤	mropd
礙	mrpko
砌	mrpsh
砘	mrpu
𥒚	mrpuk
砒	mrpp
䃈	mrppa
砲	mrpru
碟	mrptd
碒	mrc
𥐙	mrc
磳	mrcwa
砏	mrcsh
磒	mrrbc
碬	mrrse
𨀂	mrryo
礹	mrrrk
磾	mrrrj
碍	mrami
碮	mramo
碭	mramh
磵	mrana
硍	mrav
礘	mravf
碣	mrapv
舓	mraph
斫	mrhml
䂨	mrhmy
磈	mrhi
砭	mrhio
礇	mrhbk
𥐥	mrhn
矾	mrhni
碸	mrhni
砜	mrhnk
砓	mrhne
硞	mrhgr
礄	mrhkb
磻	mrhdw
礩	mrhlc
硇	mrhwk
碑	mrhwj
磇	mrhwp
硌	mrher
砟	mrhs
碥	mrhsb
砨	mrhsn
礉	mrhsk
磤	mrhse
硾	mrhjm
硃	mrhjd
碫	mrhje
硪	mrhqi
磃	mrhyu
磈	mrhui
礸	mrhuc
磫	mrhoo
矺	mrhp
砥	mrhpm
碈	mrhpa
砶	mrha
磂	mrhhw
碑	mrhhj
豆	mrt
碪	mrtmv
礡	mrtii
䃟	mrtbk
礤	mrtbf
礞	mrtbo
碘	mrtbc
礒	mrtgi
𥖄	mrtgo
磰	mrtgr
礚	mrtgt
砹	mrtk
碤	mrtlk
𥗕	mrtlf
磺	mrtlc
礣	mrtw
𥖁	mrtwi
礣	mrtwi
磸	mrtwk
𥕢	mrtwa
礴	mrtei
礷	mrtst
𥕜	mrtju
磋	mrtqm
硭	mrtyv
磁	mrtvi
𥔵	mrtvi
磡	mrtvs
礠	mrtvp
磏	mrtxc
硔	mrtc
𥕛	mrtcg
礶	mrtrg
碏	mrta
礍	mrtav
硑	mrtt
碰	mrttc
百	ma
亘	mam
𤧥	mamgi
碧	mamr
皕	mama
𤾩	mamaa
戩	mai
戬	mai
厩	maiu
厭	mabk
厚	mand
鄑	manl
櫫	mad
㔆	maln
㪽	mahl
厬	mahr
厂	mh
邪	mhnl
𠀡	mhgu
歷	mhdm
厤	mhdd
磿	mhdr
曆	mhda
𥘅	mhlv
厏	mhs
厜	mhjm
餮	mhoiv
雅	mhog
厎	mhpm
厩	mhpu
原	mhaf
鳫	mhaf
鴉	mhhaf
豇	mtm
頭	mtmbc
邢	mtnl
郖	mtnl
厨	mtdi
厪	mtlm
刑	mtln
剅	mtln
厲	mtwb
豌	mtjnu
豉	mtje
揅	mtq
厥	mtuo
雃	mtog
䝄	mtoge
蹷	mtoo
憇	mtp
亚	mtc
厮	mtcl
厝	mta
晉	mta
豍	mthwj
䜶	mtheq
毭	mthqu
鳽	mthaf
形	mthhh
𧯯	mttmc
豏	mttxc
戈	i
丶	i
广	i
冫	im
亠	im
冮	imm
𠗐	immmr
冽	immnn
𤦂	immgi
凐	immwg
凓	immwd
冱	immvm
𠗊	immvm
冴	immvh
廲	immp
㓈	immr
庢	imig
冹	imikk
𠘚	imidq
𠗕	imice
冶	imir
减	imihr
凋	imbgr
凈	imbsd
庁	imn
𠗫	imnbk
𠗠	imndt
𠗟	imnui
次	imno
凂	imnau
壮	img
凟	imgwc
凌	imgce
决	imdk
凚	imddf
凁	imdl
凍	imdw
凇	imdci
丬	iml
冲	iml
凞	imlsf
𠗃	imwk
凙	imwlj
凅	imwjr
冰	ime
臧	imsll
馮	imsqf
𠘑	imsuf
𠘕	imsuf
凞	imsuf
凄	imjlv
凊	imqmb
凑	imqkk
凜	imywd
凛	imywf
凉	imyrf
冸	imfq
凒	imumt
廈	imue
凗	imuog
𠘙	imvid
庌	imvh
凃	imomd
冾	imomr
冷	imoii
飡	imoiv
凔	imoir
准	imog
惑	imp
凝	impko
𠖳	imphh
凎	imc
庮	imcw
况	imrhu
冼	imhgu
凘	imtcl
広	ii
戔	ii
疒	iim
亝	iiim
叄	iiim
垒	iiig
廊	iiil
絫	iiif
叅	iiip
參	iiih
朗	iib
斚	iibyj
盞	iibt
郎	iinl
郞	iinl
欴	iino
奨	iik
剗	iiln
剆	iiln
庯	iijb
庬	iiuh
廘	iixp
禸	ib
宀	ib
盙	ibbt
郙	ibnl
鄘	ibnl
塱	ibg
㮾	ibd
尃	ibdi
旉	ibyhs
貟	ibuc
能	ibpp
廁	ibcn
廮	ibcv
鷛	ibha
鷛	ibhaf
鵏	ibhaf
㣑	ibhhh
冖	in
序	inin
廨	inbq
辶	inno
庭	inkg
廕	inli
永	ine
廯	infq
讠	inv
之	ino
廢	inoe
庄	ig
庒	igi
廅	igit
鄽	ignl
庤	igdi
廒	igsk
凖	igj
装	igyhv
廧	igow
庱	igce
廚	igti
义	ik
庆	ik
犬	ik
叁	ikmm
叁	ikmmm
𤨣	ikmg
猋	ikikk
貵	ikbuc
盋	ikbt
為	iknf
欸	ikno
犮	ikk
𣘼	ikd
𦘦	iklq
庵	iklu
畚	ikw
軬	ikjwj
尤	iku
慦	ikp
龙	ikp
廗	ikpb
啓	ikr
彧	ikrm
飆	ikhni
参	ikhh
参	ikhhh
床	id
术	id
磨	idmr
𪎩	idbbr
廂	idbu
塺	idg
麻	idd
靡	idlmy
爢	idlye
黀	idsje
黂	idjtc
摩	idq
𤇍	idf
糜	idfd
麼	idvi
縻	idvif
庲	idoo
麿	idrhr
魔	idhi
麽	idhi
穈	idhd
黁	idhda
犘	idhq
麾	idhqu
师	ilmlb
庣	ilmo
状	ilik
州	ilil
庸	ilb
将	ilbdi
划	iln
𡏅	ilg
廔	illv
庙	ilw
廔	ilwv
庙	ilwp
曵	ilwp
康	ile
门	ils
归	ilsm
帰	ilsmb
妆	ilv
庚	ilo
𢉼	ilob
賡	iloc
唐	ilr
庘	iwl
庽	iwlb
廛	iwcg
廙	iwtc
氷	ie
盚	iebt
㕙	ienui
𠬍	ienau
皳	iedhe
皴	iedhe
剫	ieln
裘	ieyhv
救	ieok
昶	iea
鵕	iehaf
𢒋	iehhh
户	is
廖	ismh
盛	isbt
戹	isn
郕	isnl
廳	isgp
廰	isjp
廜	isja
敷	isok
启	isr
廦	isrj
间	isa
𠙖	ishn
戎	ij
甫	ijb
庨	ijkd
庫	ijwj
求	ije
庋	ije
廟	ijjb
廀	ijfe
朮	ijc
麽	ijci
麻	ijcc
庪	iqje
緳	iqhf
鴾	iqhaf
庛	iymp
龐	iybp
廓	iydl
劘	iyln
廩	iywd
廪	iywf
爢	iyf
廬	iypt
𪗆	iyx
店	iyr
廍	iyrl
庡	iyhv
⺬	if
礻	if
祘	ifmmf
祳	ifmmv
祬	ifmig
顣	ifmbc
祆	ifmk
禋	ifmwg
禫	ifmwj
禰	ifmfb
祏	ifmr
福	ifmrw
禲	ifmtb
祓	ifikk
禟	ifilr
祴	ifit
祖	ifbm
禐	ifbme
禍	ifbbr
禂	ifbgr
廠	ifbk
禈	ifbjj
視	ifbuu
视	ifbhu
禄	ifnme
祪	ifnmu
祁	ifnl
鄬	ifnl
祢	ifnf
礽	ifnhs
社	ifg
祛	ifgi
禱	ifgni
祾	ifgce
祮	ifgr
𥜝	ifgrc
禧	ifgrr
䄎	ifkmr
𥛣	ifkpb
祐	ifkr
禕	ifdmq
祌	ifl
祧	iflmo
䄃	iflbk
䄂	iflw
神	iflwl
禙	iflpb
𥜥	iflpc
𥚃	ifwg
䄄	ifwk
祵	ifwd
祼	ifwd
禤	ifwlm
禑	ifwlb
禗	ifwp
禝	ifwce
禩	ifwtc
禩	ifwtc
祤	ifsmm
祲	ifsme
祠	ifsmr
禡	ifsqf
祒	ifshr
禃	ifjbm
禛	ifjbc
禇	ifjka
祙	ifjd
祜	ifjr
禊	ifqhk
禘	ifybb
禎	ifybc
祉	ifylm
祽	ifyoj
禞	ifyrb
禳	ifyrv
祊	ifyhs
禭	ifyto
𥙑	iffmu
禷	iffkc
礼	ifu
禨	ifvii
祿	ifvne
禒	ifvno
禴	ifomb
祫	ifomr
禬	ifoma
祔	ifodi
祄	ifoll
祚	ifos
祣	ifohv
憑	ifp
慼	ifp
礿	ifpi
祂	ifpd
祹	ifpou
祕	ifph
祶	ifcnh
祱	ifcru
蹙	ifryo
祀	ifru
祦	ifrvk
禪	ifrrj
祝	ifrhu
𥘵	ifam
禔	ifamo
禓	ifamh
禢	ifasm
禵	ifaoc
𥚕	ifaa
祈	ifhml
凴	ifhn
祋	ifhne
祰	ifhgr
祅	ifhk
祚	ifhs
祩	ifhjd
䄉	ifhqi
祑	ifhqo
禠	ifhyu
禶	ifhuc
祇	ifhvp
祗	ifhpm
鷓	ifhaf
禆	ifhhj
禖	iftmd
祺	iftmc
禚	iftgf
𥛶	iftgr
禯	iftwv
禮	iftwt
祥	iftq
禥	iftcg
禉	iftcw
尨	iuhhh
戉	iv
廱	ivug
询	ivpa
设	ivhne
庂	io
庩	iomd
瓷	iomvn
𢈈	iomr
廥	ioma
腐	ioib
庈	ioin
焤	ioif
資	iobuc
盗	iobt
垐	iog
膺	iogb
鷹	iogf
應	iogp
噟	iogr
譍	iogr
矣	iok
庥	iod
楽	iod
栥	iod
府	iodi
粢	iofd
姿	iov
餈	iooiv
座	ioog
恣	iop
咨	ior
楶	iord
秶	iohd
鶊	iohaf
廡	iotf
弋	ip
応	ip
庀	ip
弌	ipm
式	ipm
弍	ipmm
弎	ipmmm
麎	ipmmv
貳	ipmmc
麢	ipmbr
麠	ipmwm
麜	ipmwd
廎	ipmc
麤	ipipp
𪊴	ipice
麙	ipihr
麆	ipbm
貣	ipbuc
𪊶	ipnkg
鄜	ipnl
麛	ipnsj
塵	ipg
螚	iplmi
𪊽	ipwd
麕	ipwhd
麍	ipyiu
麈	ipyg
𪊓	ipyk
麐	ipykr
𪊺	ipykr
麡	ipyx
麖	ipyrf
麞	ipytj
𪋟	ipytj
熊	ipf
熋	ipf
麃	ipf
麋	ipfd
麟	ipfdq
庉	ipu
隿	ipog
態	ipp
庇	ipp
忒	ipp
麀	ipp
麅	ippru
鏖	ipc
麚	iprse
麚	iprye
庖	ipru
麌	iprvk
麣	iprrk
麂	iphn
麇	iphd
麘	iphda
𪊲	ipher
𪊟	iphqm
麔	iphor
麑	iphxu
𪈠	iphaf
鳶	iphaf
麝	iphhi
甙	iptm
麒	iptmc
慶	ixe
廌	ixf
鹿	ixp
庺	icid
鄺	icnl
廞	icno
劆	icln
𤒼	icff
怷	icp
黁	ichda
夋	iche
𪇵	ichaf
台	ir
或	irm
顑	irmbc
瓵	irmvn
觱	irnbg
邰	irnl
鄌	irnl
枲	ird
刣	irln
戓	irln
辝	irytj
炱	irf
乨	iru
感	irp
怠	irp
鶶	irhaf
廄	iaie
廐	iaiu
良	iav
戊	ih
戌	ihm
庍	ihml
烕	ihmf
威	ihmv
咸	ihmr
戍	ihi
剼	ihln
庳	ihwj
庝	ihey
成	ihs
𢦓	ihsh
螷	ihji
蠯	ihji
牟	ihq
戚	ihymf
允	ihu
廆	ihui
底	ihpm
廏	ihpe
廐	ihpu
廋	ihxe
庾	ihxo
𩾷	ihaf
廇	ihhw
庳	ihhj
毿	ihhqu
戒	it
弁	it
廑	itlm
席	itlb
廣	itlc
庿	itw
度	ite
庹	itso
庠	itq
庶	itf
䗪	itfi
庻	itoo
廉	itxc
廝	itcl
庴	ita
鴘	ithaf
庰	itt
月	b
冖	b
冂	b
⺆	b
⺝	b
⺥	b
⺼	b
爫	b
且	bm
肛	bm
囗	bm
⺜	bmm
冄	bmm
肟	bmms
朊	bmmu
脤	bmmv
冡	bmmo
冢	bmmo
具	bmmc
胵	bmig
臑	bmbb
臛	bmbg
腝	bmbk
胹	bmbl
䐓	bmbc
胢	bmnr
爰	bmke
助	bmks
𦜖	bmlm
刞	bmln
删	bmln
腼	bmwl
膘	bmwf
腰	bmwv
䐁	bmso
豚	bmso
肝	bmj
肧	bmf
胚	bmfm
𦢈	bmfb
胓	bmfj
脴	bmfr
冠	bmui
冦	bmue
脛	bmvm
雎	bmog
𦚵	bmcw
同	bmr
膈	bmrb
冨	bmrw
腷	bmrw
脰	bmrt
鴡	bmhaf
頱	bimbc
膊	bibi
脉	bine
肰	bik
胈	bikk
𤔡	bikf
肬	biku
脯	bijb
脙	bije
虢	biypu
腑	bioi
臕	bipf
膩	bipc
膔	bixp
朘	bice
脧	bice
胎	bir
朖	biav
臁	bitc
朋	bb
册	bbm
冝	bbm
肎	bbm
冊	bbm
顝	bbmbc
骾	bbmlk
骭	bbmj
旤	bbmvu
胴	bbmr
髆	bbibi
髍	bbijc
⻣	bbb
骨	bbb
朤	bbbb
覶	bbbuu
骽	bbbv
腡	bbbr
脬	bbnd
舜	bbnq
歄	bbno
髐	bbggu
骻	bbkms
骩	bbkn
骫	bbkni
骵	bbdm
脟	bbdi
骳	bbdhe
剮	bbln
髏	bbllv
𩩍	bblws
髁	bbwd
髑	bbwli
受	bbe
髎	bbsmh
㬹	bbsd
髕	bbjmc
腪	bbjj
骷	bbjr
髂	bbjhr
髖	bbjti
骴	bbymp
髈	bbybs
髄	bbykb
髓	bbykb
骸	bbyvo
髗	bbypt
骹	bbyck
髇	bbyrb
骯	bbyhn
辭	bbytj
亂	bbu
臞	bbug
鼏	bbul
覓	bbuu
脮	bbv
髉	bbobg
骱	bboll
愛	bbpe
𩨨	bbpp
骲	bbpru
咼	bbr
骺	bbhmr
骰	bbhne
髀	bbhwj
骼	bbher
鵬	bbhf
骶	bbhpm
鶻	bbhaf
髒	bbtmt
體	bbtwt
髊	bbtqm
骿	bbtt
肊	bn
脆	bnmu
膙	bnii
脡	bnkg
腱	bnkq
孚	bnd
蠫	bnlii
冤	bnui
肷	bno
膯	bnot
膽	bncr
冤	bnai
脃	bnau
脕	bnau
腬	bnhd
肚	bg
戵	bgi
胠	bgi
脚	bgil
胿	bgg
膮	bggu
周	bgr
氍	bghqu
鸜	bghaf
臌	bgte
膨	bgth
冈	bk
罓	bk
胯	bkms
肱	bki
肽	bki
脎	bkic
肍	bkn
胰	bkn
肒	bkni
郹	bknl
网	bkk
脪	bkkb
腌	bklu
肋	bks
脇	bkss
然	bkf
脄	bkf
𤉷	bkf
雞	bkog
脥	bkoo
䐭	bkpb
膫	bkcf
𦞴	bkcu
谿	bkcor
鶪	bkha
鷄	bkhaf
鶪	bkhaf
采	bd
寽	bdi
肘	bdi
郛	bdnl
冧	bdd
𦡞	bddf
腖	bdw
乳	bdu
膝	bdoe
彩	bdhhh
円	blm
腓	blmy
朓	blmo
脁	blmo
膭	blmc
胦	blbk
䏙	blbu
刖	bln
𦉫	bll
胇	blln
膢	bllv
胂	blwl
膢	blwv
见	blu
胏	blxh
腲	bwmv
膕	bwim
𦢓	bwgg
胭	bwk
腂	bwd
胛	bwl
爵	bwli
臅	bwli
腢	bwlb
𦣇	bwlg
胟	bwyi
膃	bwot
腮	bwp
腏	beee
𠖎	beee
辤	beytj
鶢	behaf
腛	bsmg
臎	bsmj
脹	bsmv
膠	bsmh
䏰	bsip
爭	bsd
服	bsle
脲	bse
鵩	bsef
臔	bsec
凸	bss
冣	bsje
腒	bsjr
胒	bsp
膒	bsrr
肕	bshi
脃	bshu
豸	bshh
𦟌	bstv
顐	bjmbc
腟	bjmg
腙	bjmf
脘	bjmu
腚	bjmo
臏	bjmc
膞	bjii
肺	bjb
脖	bjbd
腩	bjbj
鄆	bjnl
腕	bjnu
𦚱	bjkp
皸	bjdhe
蠈	bjlmi
脻	bjlo
軍	bjwj
肢	bje
胺	bjv
腔	bjcm
膣	bjcg
𦡆	bjcu
𦞳	bjcr
鶤	bjhaf
臗	bjti
膹	bjtc
用	bq
腈	bqmb
膆	bqmf
腠	bqkk
肨	bqj
甩	bqu
肤	bqo
丹	by
円	by
胩	bymy
䚻	bymr
膟	byij
膱	byia
腣	bybb
膼	bybb
膀	bybs
朧	bybp
𠖥	bybp
膪	bybr
膸	bykb
肺	bylb
刐	byln
膻	bywm
写	bysm
胘	byvi
臃	byvg
胲	byvo
腋	byok
脺	byoj
臄	bypo
臚	bypt
臍	byx
胶	byck
胋	byr
脝	byrn
腿	byav
肮	byhn
肪	byhs
膖	byhj
膇	byhr
鴅	byhaf
彤	byhhh
朣	bytg
膧	bytg
雘	bytoe
臆	bytp
腤	byta
炙	bf
胱	bfmu
膛	bfbg
爒	bfkcf
冞	bfd
脒	bfd
膦	bfdq
胖	bfq
螣	bfqi
塍	bfqg
滕	bfqe
勝	bfqs
騰	bfqf
黱	bfqf
縢	bfqf
腃	bfqu
膡	bfqu
媵	bfqv
賸	bfqc
謄	bfqr
腅	bff
朥	bffs
乿	bfu
懸	bfp
膌	bfcb
縣	bfhvf
冚	bu
目	bu
眃	bummi
眎	bummf
矖	bummp
眰	bumig
𥌎	bumbb
矐	bumbg
盯	bumn
睚	bumgg
盱	bumd
眄	bumls
瞫	bumwj
瞟	bumwf
盰	bumj
瞰	bumjk
眐	bumym
眪	bumob
矋	bumtb
眿	buine
𥅾	buig
狊	buik
瞊	builr
眓	buiv
睃	buice
眙	buir
眸	buihq
矌	buitc
眀	bub
瞹	bubbe
瞬	bubbq
睭	bubgr
睬	bubd
睜	bubsd
睴	bubjj
覞	bubu
瞁	bubuk
睍	bubuu
瞐	bubuu
𥉐	bubvk
瞑	bubac
眵	bunin
眳	bunir
矎	bunbe
睷	bunkq
䁅	bundt
睽	bunok
瞪	bunot
瞻	buncr
睌	bunau
瞲	bunhb
𥄫	bunhe
睵	bugir
瞌	bugit
眭	bugg
䁱	buggu
睦	bugcg
睖	bugce
瞦	bugrr
𥇧	bukmf
眱	bukn
睎	bukkb
䀹	bukoo
瞭	bukcf
𥈡	budmf
睞	budoo
𥇦	budhl
蜰	bulmi
眺	bulmo
瞶	bulmc
眏	bulbk
眈	bulbu
剛	buln
瞜	bullv
瞣	bullp
眒	bulwl
睤	buwml
睏	buwd
𥌓	buwla
眶	busmg
矅	busmg
矚	busei
眲	busj
𥇣	busuu
眤	busp
瞘	busrr
瞩	bushb
眧	bushr
䁥	bustr
睻	bujmm
眝	bujmn
睆	bujmu
矉	bujmc
瞚	bujmc
瞋	bujbc
睕	bujnu
睹	bujka
眛	bujd
睫	bujlo
䁪	bujjl
瞎	bujqr
矃	bujpn
瞾	bujcm
睛	buqmb
睶	buqka
盽	buqj
瞡	buqou
眦	buymp
𥌑	buybu
矓	buybp
盿	buyk
䁢	buyso
瞇	buyfd
瞝	buyub
盳	buyv
眩	buyvi
睟	buyoj
矑	buypt
瞓	buyrl
𥇍	buyaj
𥅈	buyt
瞳	buytg
瞕	buytj
煛	buf
睄	bufb
瞠	bufbg
𥋇	bufbq
矘	bufbf
眯	bufd
瞵	bufdq
眫	bufq
睠	bufqu
睒	buff
眇	bufh
朏	buu
胐	buu
䁗	buumt
䁓	buuce
鼎	buvml
眑	buvis
睩	buvne
県	buvf
矊	buvfb
䁯	buomm
睔	buomb
睮	buomn
瞼	buomo
瞺	buoma
盵	buon
睺	buonk
瞿	buog
睢	buog
膗	buog
矍	buoge
瞧	buogf
𢆡	buoq
睉	buoog
眕	buohh
瞴	buotf
愳	bup
盷	bupim
盹	bupu
䀝	bupp
眴	bupa
貝	buc
盻	bucms
瞈	bucim
睇	bucnh
朡	buce
盼	bucsh
睊	burb
睱	burye
眠	burvp
矂	burrd
睈	burhg
眖	burhu
睅	buamj
睼	buamo
瞯	buanb
瞤	buang
矙	buank
瞷	buana
眼	buav
睲	buahm
睸	buahu
盺	buhml
眨	buhio
颻	buhni
矄	buhgf
瞅	buhdf
睥	buhwj
眅	buhe
睙	buhsk
睡	buhjm
瞃	buhju
睋	buhqi
眊	buhqu
眣	buhqo
𥋘	buhfb
矁	buhfp
見	buhu
矏	buhus
繇	buhvf
眂	buhvp
矀	buhok
覹	buhok
瞛	buhoo
眡	buhpm
睧	buhpa
瞍	buhxe
睨	buhxu
𥊙	buhce
鷂	buhaf
瞗	buhaf
眽	buhhv
睥	buhht
瞱	butmj
矇	butbo
睓	butbc
眹	butk
瞞	butlb
瞄	butw
眻	butq
矆	butoe
瞸	butpd
瞨	butco
矔	butrg
瞙	butak
妥	bv
肗	bv
奚	bvik
郻	bvnl
䐂	bvne
腞	bvno
墾	bvg
腦	bvvw
臘	bvvv
懇	bvp
膷	bvhl
鵎	bvhaf
鸚	bvhaf
贝	bo
祭	bommf
腀	bomb
腧	bomn
臉	bomo
𦛼	bomc
豋	bomrt
膾	boma
朎	boii
肣	boin
腍	boip
肭	bob
朒	bobo
𦛚	bobr
肐	bon
脽	bog
臇	bogs
膲	bogf
胕	bodi
脢	bowy
胙	bos
脌	boq
詧	boymr
脞	boog
胣	bopd
腹	boae
膓	boah
胗	bohh
膴	botf
肑	bpi
肔	bpd
肫	bpu
胸	bpuk
肶	bpp
朐	bpr
胊	bpr
胞	bpru
脂	bpa
䏟	bph
脗	bphr
肳	bphh
𦦨	bxff
㓁	bc
𦉪	bc
貦	bcmmu
賑	bcmmv
䫤	bcmbc
贉	bcmwj
罕	bcmj
甖	bcmvn
賦	bcmpm
䐥	bcim
贓	bcims
賤	bcii
贂	bciih
賻	bcibi
賍	bcig
贆	bcikk
賊	bcij
賕	bcije
賐	bcice
貽	bcir
賙	bcbgr
𧶄	bcbsd
賱	bcbjj
覭	bcbuu
賏	bcbuc
賝	bcbcd
贔	bcbcc
𧴯	bcnd
鄍	bcnl
郥	bcnl
贍	bcncr
䏲	bcnh
贖	bcgwc
賄	bckb
罙	bcd
財	bcdh
貱	bcdhe
贐	bclmt
則	bcln
賗	bcll
贃	bcllp
賬	bcsmv
朌	bcsh
肦	bcsh
𧵓	bcshr
肸	bcj
貯	bcjmn
賩	bcjmf
賳	bcjir
賭	bcjka
䝼	bcqmb
賰	bcqka
譻	bcymr
贚	bcybp
賅	bcyvo
賥	bcyoj
貼	bcyr
𦋐	bcyaj
貥	bcyhn
賠	bcytr
𧵦	bcfmu
贘	bcfbc
賧	bcff
嬰	bcv
賖	bcomd
賒	bcomf
賶	bcomr
敗	bcok
罌	bcoju
貤	bcpd
賯	bcpad
鑍	bcc
𧷜	bccim
贈	bccwa
冏	bcr
腳	bcrl
脫	bcru
脱	bcru
鼆	bcrxu
貺	bcrhu
𧶽	bcamh
賵	bcabu
賜	bcaph
貶	bchio
賉	bchbt
販	bche
賂	bcher
𧵳	bchjr
貹	bchqm
𧹏	bchuc
貾	bchpm
鵙	bchaf
鸎	bchaf
贜	bctis
賟	bctbc
賺	bctxc
贌	bctco
賹	bctct
購	bcttb
冋	br
戙	bri
郮	brnl
翢	brsmm
腵	brye
囘	bru
雕	brog
胑	brc
臊	brrd
腭	brrs
脭	brhg
𦅚	brhvf
鵰	brhaf
彫	brhhh
胆	bam
腸	bamh
腽	babt
膶	bang
幂	bakb
冥	bayc
肥	bau
腥	bahm
𦢊	bate
肵	bhml
豻	bhmj
豾	bhmfm
貊	bhma
貆	bhmam
𦞙	bhi
貜	bhbue
貕	bhbvk
肌	bhn
冗	bhn
股	bhne
爲	bhnf
臐	bhgf
脷	bhdn
膰	bhdw
腇	bhdv
豺	bhdh
𧲱	bhlbk
貗	bhllv
貄	bhlq
貍	bhwg
脾	bhwj
膍	bhwp
胮	bheq
胳	bher
胙	bhs
貙	bhsrr
貂	bhshr
腄	bhjm
腫	bhjg
䏭	bhjd
𧳅	bhjlk
腶	bhje
腁	bhjj
腯	bhju
貁	bhjc
胜	bhqm
胅	bhqo
貒	bhumb
貀	bhuu
膬	bhuu
臢	bhuc
胍	bhvo
貐	bhomn
豽	bhob
胻	bhon
貅	bhod
胝	bhpm
豹	bhpi
豼	bhpp
豿	bhpr
舀	bhx
膄	bhxe
腉	bhxu
腴	bhxo
貑	bhrse
貚	bhrrj
胉	bha
腺	bhae
冟	bhap
貈	bhhby
貏	bhhwj
貔	bhhwp
貉	bhher
脈	bhhv
貎	bhhxu
貃	bhha
貌	bhhau
肜	bhhh
貓	bhtw
貖	bhtct
貛	bhtrg
貘	bhtak
皿	bt
冊	bt
頯	btmbc
𩓚	btmbc
腜	btmd
𦠜	btmj
𦝁	btmc
臟	btis
𦛨	btbs
朦	btbo
腆	btbc
膳	btgr
朕	btk
刪	btln
删	btln
朠	btlk
臙	btlf
膿	btwv
膵	btyj
罔	btyv
岡	btu
臒	btoe
膁	btxc
𦡮	btca
膉	btct
腊	bta
冪	btab
膜	btak
臈	btav
肼	btt
胼	btt
弓	n
⺄	n
乛	n
亅	n
彐	nmm
录	nmme
骏	nmice
𢏺	nmbn
彚	nmbwd
鶸	nmnmf
弱	nmnim
郔	nmnl
檃	nmd
疎	nmdl
疏	nmdl
蜑	nmlmi
彊	nmwm
弻	nmwn
危	nmsu
疏	nmyiu
彌	nmfb
弳	nmvm
矦	nmok
弼	nman
𡘓	nmhqo
夕	ni
弘	ni
甬	nibq
多	nini
𠓗	ninii
予	ninn
酁	ninl
矛	ninh
強	nili
劖	niln
圅	niwj
夘	nisl
夗	nisu
夤	nijmc
舛	niq
外	niy
謽	niymr
𧥧	niymr
癶	niyo
婱	niv
飧	nioiv
麁	nixp
名	nir
𡖖	niail
犟	nihq
夝	nihqm
鵵	nihaf
彍	nitc
瓕	nbmgi
觨	nbme
觩	nbije
弸	nbb
夐	nbbue
敻	nbbue
𢿌	nbbue
觤	nbnmu
觼	nbnbe
觙	nbnhe
角	nbg
墮	nbg
觟	nbgg
奐	nbk
觭	nbkmr
勇	nbks
觔	nbks
觖	nbdk
觫	nbdl
触	nblmi
劀	nbln
觸	nbwli
䚡	nbwp
解	nbshq
觰	nbjka
⻆	nbq
斛	nbyj
觪	nbytj
觥	nbfmu
嶞	nbu
彏	nbue
觿	nbuob
負	nbuc
觻	nbvid
觮	nbvne
觓	nbvl
𧤤	nbogs
𧢲	nboo
隳	nbop
觴	nboah
恿	nbp
觶	nbrrj
觛	nbam
觡	nbher
𧣈	nbhq
氄	nbhqu
觚	nbhvo
觝	nbhpm
觬	nbhxu
鷸	nbhaf
觵	nbtmc
觲	nbtgq
觾	nbtlf
觧	nbtq
了	nn
亇	nn
孑	nnm
預	nnmbc
鬻	nnmrb
𩱳	nnmrb
豫	nnnao
廴	nnk
㷇	nnkf
翗	nnsmm
卶	nnsl
承	nnqo
𠄘	nnqo
𠙶	nnu
郺	nnvvu
孓	nno
弞	nno
夠	nnpr
叾	nnr
𢎽	nnhe
丑	ng
頲	ngmbc
疆	ngmwm
厾	ngi
夊	nk
又	nk
廴	nk
廼	nkmcw
戣	nki
瞀	nkbu
𢌡	nkbcr
㢠	nkbr
鄈	nknl
堥	nkg
楘	nkd
蝥	nklmi
廸	nklw
建	nklq
廽	nkwyl
廻	nkwr
騖	nksqf
煞	nkf
嵍	nku
婺	nkv
廵	nkvvv
鍪	nkc
𢌥	nkrhg
暓	nka
郔	nkhml
廷	nkhg
延	nkhym
廹	nkha
鶩	nkhaf
鞪	nktlj
子	nd
孺	ndmbb
孲	ndmlm
孭	ndbuc
孾	ndbcv
孟	ndbt
𡥼	ndnbc
孖	ndnd
孨	ndndd
孴	ndnda
㝃	ndnau
孻	ndlmt
刴	ndln
𣫮	ndwyi
孮	ndjmf
𡥪	ndymr
孩	ndyvo
孔	ndu
孜	ndok
孢	ndpru
𡥄	ndr
孫	ndhvf
孤	ndhvo
鶔	ndhaf
𡦖	ndtlb
⻏	nl
⻖	nl
引	nl
阝	nl
弔	nl
际	nlmmf
阮	nlmmu
陙	nlmmv
隭	nlmbb
陾	nlmbk
陑	nlmbl
陋	nlmbv
阿	nlmnr
陻	nlmwg
阨	nlmsu
阷	nlmym
阫	nlmf
𨸹	nlmfm
隬	nlmfb
𨸶	nlmfj
阢	nlmu
陘	nlmvm
陃	nlmob
陚	nlmpm
隔	nlmrb
陌	nlma
阸	nlisn
陠	nlijb
陖	nlice
阭	nlihu
隇	nlihv
阴	nlb
阻	nlbm
隱	nlbmp
𢏐	nlbi
隠	nlbsp
際	nlbof
䧟	nlbhx
盄	nlbt
陊	nlnin
𨺳	nlnbs
阠	nlnj
隥	nlnot
陷	nlnhx
阹	nlgi
隯	nlgni
隢	nlggu
隞	nlgsk
陡	nlgyo
陸	nlgcg
陵	nlgce
隓	nlkmm
隋	nlkmb
陓	nlkms
陭	nlkmr
陏	nlkb
阞	nlks
陜	nlko
陝	nlkoo
陜	nlkoo
陳	nldw
敶	nldwk
陂	nldhe
陫	nllmy
隤	nllmc
隈	nlwmv
隅	nlwlb
𨺬	nlwol
陿	nlsko
陬	nlsje
隁	nlsav
院	nljmu
䧥	nljip
陼	nljka
陣	nljwj
陀	nljp
隫	nljtc
隴	nlybp
随	nlykb
隨	nlykb
阯	nlylm
𨺗	nlylo
陟	nlylh
阧	nlyj
陔	nlyvo
隮	nlyx
阽	nlyr
隡	nlyhm
阬	nlyhn
防	nlyhs
隵	nlyti
障	nlytj
隧	nlyto
陪	nlytr
隌	nlyta
阦	nlf
隣	nlfdq
隙	nlfhf
隲	nlfhf
隑	nlumt
隟	nlvvd
险	nlomm
陯	nlomb
隃	nlomn
除	nlomd
險	nlomo
阾	nloii
陰	nloii
阣	nlon
陮	nlog
附	nlodi
阼	nlos
隂	nlosi
陁	nlopd
阤	nlpd
陱	nlpfd
陶	nlpou
阰	nlpp
陛	nlppg
階	nlppa
𨹥	nlcnh
隕	nlrbc
𨹦	nlrd
阳	nla
隄	nlamo
陽	nlamh
𨻙	nlafu
限	nlav
隰	nlavf
隩	nlhbk
𨺲	nlhlb
陴	nlhwj
阪	nlhe
隆	nlhem
降	nlheq
阼	nlhs
阸	nlhsn
阡	nlhj
陲	nlhjm
隀	nlhjg
陎	nlhjd
隗	nlhui
阺	nlhpm
隉	nlhxg
隖	nlhrf
隍	nlhag
隝	nlhaf
𨻧	nlhhw
陴	nlhhj
阩	nlht
陞	nlhtg
陹	nlhta
䧧	nltgi
隊	nltpo
隒	nltxc
隘	nltct
阱	nltt
乪	nw
鱼	nwm
𡕷	nwbue
勇	nwks
螴	nwlmi
亀	nwlu
彋	nwlv
魚	nwf
魯	nwfa
龟	nwu
彃	nwtj
氹	ne
氶	ne
丞	nem
脀	nemb
卺	nemsu
巹	nemsu
烝	nemf
𡍵	neg
剥	neln
焏	nef
戼	nsmls
張	nsmv
鼐	nsbul
盁	nsbt
盈	nsbt
孕	nsnd
邹	nsnl
埅	nsg
奦	nsk
争	nsd
朶	nsd
𠃮	nse
弡	nss
弭	nsj
呄	nsjr
尕	nsf
熃	nsf
㜈	nsv
急	nsp
彄	nsrr
夃	nshe
弨	nshr
卂	nj
塦	njg
蝨	njlii
鳵	njhaf
丮	nq
𢩦	nq
桀	nqd
蟹	nqlmi
㣃	nybn
⺪	nylm
弦	nyvi
疋	nyo
弴	nyrd
弶	nyrf
尔	nf
魟	nfm
鱺	nfmmp
鯃	nfmmr
鱈	nfmbm
鱬	nfmbb
鮞	nfmbl
鱏	nfmbj
魺	nfmnr
玺	nfmgi
鱷	nfmgr
鯁	nfmlk
鱏	nfmwj
鰾	nfmwf
魾	nfmfm
鮃	nfmfj
魱	nfmvm
鯂	nfmcw
鱱	nfmtb
鱖	nfmto
鰺	nfiih
鮁	nfikk
魷	nfiku
鱅	nfilb
鯿	nfisb
𩸭	nfisk
鯆	nfijb
鯄	nfije
鮻	nfice
鮐	nfir
䱛	nfirm
鰄	nfihv
鰔	nfihr
弰	nfb
鰀	nfbme
鮦	nfbmr
䱻	nfbbb
鯛	nfbgr
鯶	nfbjj
鰶	nfbof
鰩	nfbou
鰂	nfbcn
鱡	nfbcj
鰯	nfnmm
鯴	nfnmi
鮠	nfnmu
鯒	nfnib
魣	nfnin
鯅	nfnkm
鰎	nfnkq
鯭	nfndt
𩺰	nfnwf
鱻	nfnff
鱍	nfnoe
鮸	nfnau
鱌	nfnao
鱊	nfnhb
鰇	nfnhd
𩵚	nfg
魼	nfgi
鮭	nfgg
鱙	nfggu
鯥	nfgcg
鯪	nfgce
鮚	nfgr
鯍	nfkiv
鮪	nfkb
𩸆	nfklu
𩵼	nfke
𩶛	nfksr
粥	nfdn
鯻	nfdln
鯟	nfdw
鰊	nfdwf
鯠	nfdoo
鮍	nfdhe
鯡	nflmy
鮡	nflmo
䱀	nflbk
魝	nfln
鮄	nflln
鮋	nflw
鱐	nflx
鯉	nfwg
魻	nfwl
鰅	nfwlb
鰥	nfwle
鱞	nfwlv
弾	nfwj
鯝	nfwjr
鮂	nfwo
鰮	nfwot
鰓	nfwp
鮰	nfwr
䲤	nfemw
鰠	nfeii
鯋	nfefh
鮙	nfsmm
鱘	nfsmi
鯞	nfsmb
鰼	nfsma
鮶	nfskr
鰹	nfseg
鮔	nfss
鯫	nfsje
鮿	nfsju
䲁	nfsfi
魢	nfsu
鰸	nfsrr
鰋	nfsav
魛	nfsh
鮉	nfshr
鯮	nfjmf
鯇	nfjmu
鱄	nfjii
鮳	nfjks
鮇	nfjd
鮟	nfjv
鮀	nfjp
鰭	nfjpa
鰫	nfjcr
鮕	nfjr
鰗	nfjrb
鱝	nfjtc
鯖	nfqmb
鰿	nfqmc
鰆	nfqka
䲅	nfqou
鮛	nfymf
鱁	nfymo
鱥	nfymh
𩼣	nfybb
鰟	nfybs
魰	nfyk
𩻸	nfyle
鱣	nfywm
鰱	nfyjj
鮌	nfyvi
鱋	nfypm
鰬	nfypk
鯱	nfypu
鱸	nfypt
鱭	nfyx
鮫	nfyck
鮎	nfyr
鰝	nfyrb
鯙	nfyrd
鯨	nfyrf
魧	nfyhn
魴	nfyhs
𩺬	nfyhr
𩶘	nfyt
鱆	nfytj
鯜	nfytv
鮹	nffb
鱨	nffba
鱗	nffdq
魦	nffh
䰲	nfu
𩻃	nfujf
鯼	nfuce
鱳	nfvid
鯔	nfvvw
鱲	nfvvv
鯩	nfomb
鯾	nfomk
鮽	nfomd
鮯	nfomr
鱠	nfoma
魿	nfoii
鯰	nfoip
䱽	nfoir
魶	nfob
鯸	nfonk
䰻	nfok
鮒	nfodi
鰷	nfold
鮓	nfos
魤	nfop
鰒	nfoae
愻	nfp
䱭	nfpmm
魡	nfpi
魨	nfpu
鮈	nfpr
鮑	nfpru
鮨	nfpa
鮅	nfph
魩	nfphh
鰈	nfptd
魵	nfcsh
鮵	nfcru
鰕	nfrye
鱦	nfrxu
鱢	nfrrd
鰐	nfrrs
鱓	nfrrj
䱇	nfam
鯷	nfamo
鯽	nfail
鰛	nfabt
鰣	nfagi
鰻	nfawe
鰨	nfasm
䰾	nfau
鯤	nfapp
鯣	nfaph
鯧	nfaa
鯹	nfahm
鱵	nfhir
魫	nfhbu
鯌	nfhgr
鱎	nfhkb
穌	nfhd
鯏	nfhdn
鯚	nfhdd
鱕	nfhdw
鰍	nfhdf
魬	nfhe
鮗	nfhey
鮥	nfher
魲	nfhs
鮓	nfhs
鯿	nfhsb
鮢	nfhjd
𩹨	nfhje
鮏	nfhqm
鯀	nfhvf
鯦	nfhor
魠	nfhp
鮣	nfhpl
鯢	nfhxu
鱮	nfhxc
鯓	nfhxh
鰤	nfhrb
鰉	nfhag
鰡	nfhhw
魽	nftm
鯕	nftmc
鱑	nftmc
鱔	nftgr
鱒	nftwi
鱴	nftwi
鰽	nftwa
鱧	nftwt
鰳	nftjs
鮮	nftq
𩷶	nftyv
鰦	nftvi
𩼰	nftvp
鱯	nftoe
鱶	nftov
鰜	nftxc
鰌	nftcw
鱹	nftrg
乙	nu
頠	numbc
兔	nui
眢	nubu
盌	nubt
勉	nuks
弢	nue
弢	nue
駌	nusqf
妴	nuv
怨	nup
凾	nure
𡦀	nuab
鴛	nuhaf
饣	nv
马	nvsm
欠	no
飞	no
久	no
癸	nomk
発	nomku
凳	nomrn
登	nomrt
胥	nob
飝	nonoo
發	nonhe
墜	nog
墬	nog
弣	nodi
蛋	nolmi
弥	nof
灸	nof
𤉋	nof
𢝵	nop
𢞵	noph
鐆	noc
疍	noam
癹	nohne
飛	nohto
𣬚	npnii
弛	npd
櫽	npd
卍	nx
欿	nxno
燄	nxff
龜	nxu
鵮	nxhaf
小	nc
弹	ncwj
詹	ncymr
甔	nrmvn
弲	nrb
强	nrli
娿	nrv
𨿅	nrog
㲋	nrpp
毚	nrppi
彈	nrrj
𣄽	na
色	nau
弝	nau
象	napo
兔	nahi
免	nahu
矞	nhbcr
柔	nhd
虱	nhli
蟊	nhlii
及	nhe
乃	nhs
騭	nhsqf
矟	nhfb
𡛺	nhv
弧	nhvo
矝	nhoii
矜	nhoin
敄	nhok
務	nhoks
弤	nhpm
矠	nhta
戤	nti
鄧	ntnl
𨜏	ntnl
勐	ntks
彉	ntlc
凳	nthn
土	g
坛	gmmi
圬	gmms
坃	gmmu
垤	gmig
墵	gmbi
壩	gmbb
壖	gmbb
堧	gmbk
圢	gmn
坷	gmnr
𡊩	gmgi
堐	gmgg
圩	gmd
壢	gmdm
埡	gmlm
埂	gmlk
壃	gmwm
堙	gmwg
塛	gmwd
墰	gmwj
墂	gmwf
坂	gme
㙇	gmso
𡑒	gmjk
墕	gmyf
坏	gmf
坯	gmfm
坪	gmfj
坘	gmvm
鋆	gmc
坧	gmr
塥	gmrb
堛	gmrw
垣	gmam
壢	gmhm
塬	gmhf
去	gi
圡	gi
㙟	giib
墋	giih
贄	gibuc
盍	gibt
垿	ginn
邿	ginl
𨚫	ginl
堼	gig
墊	gig
坺	gikk
勢	giks
劫	giks
槷	gid
蟄	gilmi
𡌺	gili
墉	gilb
幇	gilb
刦	giln
𡐓	gile
塘	gilr
漐	gie
翿	gismm
刼	gisk
却	gisl
叝	gisle
騺	gisqf
刧	gish
刼	gishi
埔	gijb
摯	giq
摰	giq
謺	giymr
熱	gif
烖	gif
縶	givif
赱	gio
埃	giok
慹	gip
塶	gixp
埈	gice
坮	gir
域	girm
鼁	girxu
暬	gia
埌	giav
朅	giapv
魗	gihi
城	gihs
犎	gihq
墄	gihf
㙎	gihv
堿	gihr
幫	gihab
鷙	gihaf
弆	git
鞤	gitlj
墌	gitf
壙	gitc
冉	gb
坥	gbm
壼	gbmm
蠧	gbmi
壳	gbmn
槖	gbmd
塚	gbmo
塜	gbmo
埧	gbmc
垌	gbmr
蠧	gbmri
壹	gbmt
堋	gbb
堝	gbbr
垺	gbnd
埰	gbd
埒	gbdi
埓	gbdi
壷	gblm
壺	gblm
埩	gbsd
堚	gbjj
坍	gby
垷	gbuu
垻	gbuc
壱	gbp
堔	gbcd
𡑕	gbcd
埛	gbcr
坰	gbr
塓	gbac
壳	gbhn
觳	gbhne
坈	gbhu
売	gbhu
塪	gbhx
堈	gbtu
壽	gnmi
燾	gnmf
垝	gnmu
埇	gnib
垑	gnin
埆	gnbg
埏	gnkm
垜	gnsd
坎	gno
壻	gnob
墢	gnoe
墱	gnot
堍	gnai
彀	gnhn
殻	gnhne
殼	gnhne
圾	gnhe
埳	gnhx
圭	gg
壔	ggni
邽	ggnl
垚	ggg
壵	ggg
𡋣	ggg
堯	gggu
墝	gggu
𡓨	gggog
龳	gggcg
埶	ggkni
勎	ggks
封	ggdi
刲	ggln
堘	ggqg
卦	ggy
燅	ggff
奊	ggvk
墻	ggow
恚	ggp
墙	ggcw
堎	ggce
鼃	ggrxu
䵷	ggrxu
瑴	gghne
鵱	gghaf
堶	gkmb
垮	gkms
埼	gkmr
獒	gkik
贅	gkbuc
盩	gkbt
鰲	gknwf
塽	gkkk
螫	gklm
螯	gklmi
㘵	gklb
埯	gklu
埯	gklv
聱	gksj
驁	gksqf
摮	gkq
謷	gkymr
熬	gkf
嶅	gku
嫯	gkv
埉	gkoo
墆	gkpb
鏊	gkc
嗸	gkr
鼇	gkrxu
𣊁	gka
鷔	gkhaf
寺	gdi
块	gdk
埬	gdw
堜	gdwf
榖	gdhn
穀	gdhne
糓	gdhne
坡	gdhe
垗	glmo
墤	glmc
坱	glbk
赤	glnc
坲	glln
圳	glll
塿	gllv
坤	glwl
塿	glwv
埭	gle
垏	glq
𡊰	gw
埋	gwg
堁	gwd
堽	gwlm
堣	gwlb
夁	gwlw
塄	gwls
墿	gwlj
賣	gwlc
毐	gwj
堌	gwjr
坶	gwyi
堺	gwol
塭	gwot
磬	gemr
墚	geid
瞽	gebu
螜	gelmi
鼘	gelxl
漀	gee
鼜	geeii
鼚	gesmv
聲	gesj
撀	geq
謦	geymr
韾	geyta
㷫	gef
鼞	gefbg
罄	geoju
愨	gep
慤	gep
𢡱	gep
鏧	gec
毊	gehkb
馨	gehda
鼙	gehwj
鼕	gehey
鼛	gehor
埽	gsmb
埐	gsme
壏	gsit
墭	gsbt
㙺	gslc
𡐖	gseg
墀	gseq
垇	gssu
壣	gsjt
墀	gsyq
圮	gsu
𡉏	gsu
堀	gsuu
敖	gsok
坭	gsp
壀	gsrj
塸	gsrr
堰	gsav
塀	gstt
塇	gjmm
坾	gjmn
㘾	gjmd
垸	gjmu
埞	gjmo
塼	gjii
埴	gjbm
𡎜	gjbj
填	gjbc
埦	gjnu
執	gjkni
𡏾	gjkr
堵	gjka
垨	gjdi
𡌄	gjwj
壊	gjwv
報	gjsle
墘	gjjn
垵	gjv
坨	gjp
埪	gjcm
塎	gjcr
轂	gjhne
瓡	gjhvo
垞	gjhp
墳	gjtc
埥	gqmb
塐	gqmf
埲	gqkq
堾	gqka
垹	gqjl
𡐤	gqhf
圤	gy
圵	gym
堉	gyib
塝	gybs
壠	gybp
𡐿	gygj
墶	gygq
坟	gyk
墩	gydk
墎	gydl
址	gylm
壝	gylc
埗	gylh
壇	gywm
塷	gywi
壈	gywd
壞	gywv
埱	gyfe
垴	gyuk
𡊨	gyvi
垓	gyvo
走	gyo
埣	gyoj
墟	gypm
㙈	gypu
壉	gypo
壚	gypt
墑	gycb
墒	gycb
坫	gyr
塙	gyrb
埻	gyrd
壤	gyrv
壕	gyro
坑	gyhn
坊	gyhs
塳	gyhj
塠	gyhr
垃	gyt
墥	gytg
墇	gytj
垶	gytj
境	gytu
培	gytr
堷	gyta
灻	gf
垙	gfmu
壋	gfbw
𧡘	gfbuu
款	gfno
隷	gfle
坢	gfq
埢	gfqu
埮	gff
塉	gfcb
鷇	gfhn
縠	gfhne
圠	gu
顤	gumbc
塏	gumt
塴	gubb
㚁	guggu
𡭄	gudi
翹	gusmm
𢿣	guye
埁	guon
墔	guog
瞉	guhne
㘭	gvis
坳	gvis
堟	gvno
坵	gom
埨	gomb
堬	gomn
趔	gomnn
墖	gomw
赶	gomj
垥	gomr
趑	goimo
坽	goii
坅	goin
垘	goik
越	goiv
趦	goior
埝	goip
趄	gobm
圪	gon
趍	gonin
堠	gonk
趋	gonsm
趂	gonf
赼	gono
堆	gog
趬	goggu
趌	gogr
坆	gok
垁	gok
赲	goks
坿	godi
赽	godk
趚	godl
趒	golmo
圿	goll
趀	golxh
嗇	gowr
趩	gowtc
趐	gosmm
趯	gosmg
趣	gosje
趘	goshu
超	goshr
趤	gojmr
赴	goy
趈	goyr
趠	goyaj
趇	goyt
趙	gofb
趟	gofbr
赻	gofh
赸	gou
趉	gouu
趢	govne
赳	govl
龪	goo
赺	gooin
趝	gooip
䞘	goon
趡	goog
趭	googf
趖	gooog
趁	goohh
赹	gopmm
趜	gopfd
趨	gopuu
趛	goc
堢	gord
趗	goryo
起	goru
趮	gorrd
塩	gort
趕	goamj
趧	goamo
䞶	goamh
𧼮	goamh
塲	goah
赾	gohml
趓	gohnd
豰	gohne
趫	gohkb
䞦	goher
趎	gohjd
趏	gohjr
趃	gohqo
趲	gohuc
赿	gohvp
趆	gohpm
趪	gotlc
墲	gotf
趥	gotcw
志	gp
均	gpmm
堩	gpmm
圴	gpi
均	gpim
覟	gpbuu
塡	gpbc
地	gpd
坉	gpu
堦	gppa
坸	gpr
圽	gphh
堞	gptd
頳	gcmbc
塕	gcim
赯	gcilr
覿	gcbuu
郝	gcnl
赥	gcno
赩	gcnau
坴	gcg
赫	gcglc
皾	gcdhe
赨	gclmi
増	gcwa
增	gcwa
赧	gcsle
坋	gcsh
赭	gcjka
赬	gcybc
赦	gcok
赮	gcrse
鼀	gcrxu
夌	gche
吉	gr
頡	grmbc
噽	grmfm
嚭	grmfr
埍	grb
臺	grbg
塤	grbc
郆	grnl
歖	grno
欯	grno
喆	grgr
嚞	grgr
囍	grgrr
嚞	grgrr
劼	grks
㓤	grln
翓	grsmm
𡎎	grsj
敼	grye
圯	gru
垊	grvp
憙	grp
壧	grrk
堮	grrs
墠	grrj
喪	grrv
嗀	grhne
嗀	grhne
埕	grhg
袁	grhv
鴶	grhaf
𪇟	grhaf
壴	grt
熹	grtf
憙	grtp
喜	grtr
嘉	grtr
坦	gam
壜	gami
垾	gamj
堤	gamo
場	gamh
壛	ganx
塒	gagi
墁	gawe
塌	gasm
垠	gav
堨	gapv
堒	gapp
埸	gaph
声	gah
堳	gahu
圻	ghml
坼	ghmy
甏	ghmvn
垢	ghmr
塊	ghi
墺	ghbk
垍	ghbu
垧	ghbr
堸	ghni
垛	ghnd
坄	ghne
壎	ghgf
𡌃	ghgr
墧	ghkb
墦	ghdw
塖	ghdp
蟚	ghlmi
埤	ghwj
坂	ghe
埄	ghej
垎	gher
墽	ghsk
圲	ghj
埵	ghjm
堹	ghjg
塅	ghje
垀	ghfd
塊	ghui
坁	ghvp
㙡	ghoo
坻	ghpm
堄	ghxu
埠	ghrj
塢	ghrf
垖	ghrr
堭	ghag
𡏭	ghad
塯	ghhw
埤	ghhj
坩	gtm
墷	gtmj
堪	gtmv
墴	gtmc
𡤜	gtiov
懿	gtiop
𡄻	gtior
㙉	gtbc
㦤	gtnop
墡	gtgr
壒	gtgt
尌	gtdi
皷	gtdhe
墐	gtlm
𡎘	gtlk
墫	gtwi
壿	gtwi
𧰒	gtwim
壾	gtss
幸	gtj
鼓	gtje
垟	gtq
鼔	gtye
塃	gtyv
亄	gtu
墈	gtvs
𡏆	gtol
𡒶	gtov
塔	gtor
垬	gtc
墣	gtco
塨	gtcp
壦	gtrg
塻	gtak
𡓽	gthf
彭	gthhh
垪	gtt
𡌶	gttc
疒	k
大	k
乂	k
𠂇	k
左	km
疘	km
夽	kmmi
夸	kmms
疞	kmms
奈	kmmf
痦	kmmr
痓	kmig
癨	kmbg
癗	kmbw
疔	kmn
𤹐	kmnf
奇	kmnr
疴	kmnr
㿀	kmgg
癍	kmgg
癧	kmdm
瘂	kmlm
癅	kmlw
奤	kmwl
瘭	kmwf
瘃	kmso
症	kmym
痞	kmfr
痙	kmvm
疨	kmvh
病	kmob
痘	kmrt
奭	kmaa
癧	kmhm
厷	ki
太	ki
盇	kibt
郄	kinl
疣	kiku
翃	kismm
痡	kijb
痝	kiuh
奿	kiv
雄	kiog
痠	kice
有	kb
冇	kb
疽	kbm
瓻	kbmvn
痌	kbmr
𠕇	kbi
戫	kbirm
𢒰	kbihm
痭	kbb
瘑	kbbr
郗	kbnl
郁	kbnl
郩	kbnl
欷	kbno
奝	kbgr
痈	kbq
龓	kbybp
㿜	kbub
癯	kbug
瘵	kbof
癭	kbcv
殽	kbhne
毻	kbhqu
鵗	kbhaf
九	kn
𡯁	kn
夷	kn
頄	knmbc
丸	kni
厹	kni
痛	knib
奓	knin
痑	knin
㚚	knir
瘓	knbk
𤷪	kndt
㽼	knl
癃	knlm
癮	knlp
痾	knlr
瘬	knsv
卆	knj
訄	knymr
虓	knypu
癬	knfq
疚	kno
癈	knoe
癚	kncr
叴	knr
旭	kna
旮	kna
疓	knhs
鳩	knhaf
馗	knthu
圶	kg
奎	kgg
㥣	kggp
痔	kgdi
痣	kgp
鵟	kghaf
夶	kk
爻	kk
肴	kkb
痏	kkb
爼	kkbm
痍	kkn
𡘙	kkk
爽	kkkk
希	kklb
痷	kklu
夯	kks
痂	kksr
瘞	kkog
瘱	kkop
療	kkcf
瘸	kkrb
鷞	kkhaf
鸑	kkhaf
东	kd
疛	kdi
弑	kdipm
𤷫	kdbn
𨚲	kdnl
疦	kdk
痳	kdd
瘌	kdln
瘷	kdlk
瘶	kdlo
癩	kdlc
雑	kdog
敎	kdok
殺	kdhne
疲	kdhe
痋	klmi
痱	klmy
布	klb
刈	kln
存	klnd
在	klg
夰	kll
疿	klln
夼	klll
𡘊	klw
奄	klwu
瘻	klwv
奋	kw
痹	kwml
癦	kwgg
𤼎	kwgt
瘝	kwle
癏	kwlv
癳	kwwf
痼	kwjr
瘰	kwvf
瘟	kwot
痐	kwr
友	ke
瘙	keii
奫	kell
痧	kefh
力	ks
套	ksmi
瘺	ksmb
痮	ksmv
瘳	ksmh
郀	ksnl
脅	ksksb
劦	kskss
姭	ksksv
刳	ksln
勰	kswp
耷	ksj
𤶸	ksql
劜	ksu
匏	kspru
办	ksc
癜	ksce
加	ksr
癖	ksrj
奩	ksrr
綔	kshvf
瓠	kshvo
鴮	kshaf
夲	kj
瘨	kjbc
痚	kjkd
奢	kjka
瘏	kjka
癲	kjcc
痲	kjcc
痯	kjrr
奔	kjt
瘈	kqhk
瘛	kqhp
疵	kymp
疰	kyg
癛	kywd
瘯	kysk
瘀	kysy
痃	kyvi
奒	kyvo
痎	kyvo
瘁	kyoj
瘧	kypm
癠	kyx
痁	kyr
瘴	kytj
癔	kytp
瘖	kyta
灰	kf
疢	kf
痟	kfb
盔	kfbt
痰	kff
癆	kffs
悐	kfp
𢠃	kfp
瘠	kfcb
鷯	kfhaf
疝	ku
尢	ku
尪	kumg
尳	kubbb
尯	kunmu
尷	kusmt
尷	kusit
尬	kuoll
尥	kupi
尰	kuhjg
鵪	kuhaf
厺	kvi
𤸻	kveq
癵	kvfb
癴	kvfq
癰	kvug
㿈	kvhg
頰	kombc
瘉	komn
痊	komg
癒	komp
癐	koma
瘡	koir
𧶘	kobuc
疙	kon
瘊	konk
郟	konl
奞	kog
痽	kog
奪	kogi
奮	kogw
癄	kogf
𡚒	kogx
疾	kok
痴	kokr
疥	koll
痗	kowy
痄	kos
夾	koo
痤	koog
㤲	kop
鵊	kohaf
疹	kohh
疕	kp
慸	kpbbp
帶	kpblb
癡	kpko
疪	kpp
痀	kpr
疱	kpru
疶	kpt
弒	kcipm
眘	kcbu
刹	kcln
剎	kcln
𤺧	kcwa
痥	kcru
昚	kca
閷	kcano
尞	kcaf
殺	kchne
右	kr
䫑	krmbc
哿	krmnr
㾓	krb
賀	krbuc
欹	krno
架	krd
剞	krln
瘕	krse
駕	krsqf
攲	krje
敧	krye
袈	kryhv
妿	krv
疻	krc
癉	krrj
癌	krru
毠	krhqu
鵸	krhaf
鴐	krhaf
疸	kam
瘍	kamh
奛	kab
癇	kanb
癎	kana
橥	kad
疤	kau
痕	kav
奲	karrj
犭	kh
狋	khmmf
獳	khmbb
獶	khmbe
狂	khmg
㹴	khmlk
𤢂	khmwd
犴	khmj
狉	khmfm
獮	khmfb
犽	khmvh
𤞏	khmcw
獿	khmce
狟	khmam
獂	khmhf
獗	khmto
猼	khibi
𤜥	khik
犹	khiku
犾	khiku
狨	khij
狵	khiuh
狘	khiv
疺	khio
狻	khice
狼	khiav
狁	khihu
獷	khitc
狙	khbm
猨	khbme
狪	khbmr
猾	khbbb
猧	khbbr
痸	khbn
猙	khbsd
玃	khbue
狽	khbuc
猺	khbou
狦	khbtt
獼	khnmb
瘋	khni
獬	khnbq
狃	khng
峱	khngu
狿	khnkm
猻	khndf
犼	khndu
猛	khndt
疫	khne
𤟠	khnob
猤	khnok
獝	khnhb
猱	khnhd
𤜯	khnhe
獟	khggu
獓	khgsk
狤	khgr
猿	khgrv
猗	khkmr
犰	khkn
犱	khkni
狶	khkkb
狹	khkoo
獠	khkcf
狭	khkt
痢	khdn
痵	khdd
獺	khdlc
痜	khdu
痿	khdv
癪	khdc
猹	khdam
犲	khdh
狇	khdh
狓	khdhe
狆	khl
独	khlmi
狣	khlmo
狒	khlln
猥	khwmv
猬	khwb
狸	khwg
猓	khwd
狎	khwl
獨	khwli
玀	khwlg
獧	khwlv
痺	khwj
疼	khey
猀	khefh
痄	khs
獁	khsqf
犯	khsu
狔	khsp
猔	khjmf
獱	khjmc
犻	khjb
瘇	khjg
狫	khjkp
猪	khjka
狩	khjdi
獑	khjjl
獰	khjpn
狖	khjc
狜	khjr
猢	khjrb
猜	khqmb
獉	khqkd
猰	khqhk
狾	khqhl
狺	khymr
獩	khymh
瘢	khye
犿	khyy
猝	khyoj
猇	khypu
狡	khyck
獄	khyrk
猄	khyrf
獽	khyrv
犺	khyhn
獞	khytg
獐	khytj
獍	khytu
狄	khf
獙	khfbk
猯	khumb
瘣	khui
癟	khub
獕	khuog
瘜	khup
㿗	khuc
猣	khuce
猭	khvno
獵	khvvv
疧	khvp
狳	khomd
獫	khomo
猞	khomr
獪	khoma
狑	khoii
獊	khoir
犵	khon
猴	khonk
猚	khog
癥	khok
癓	khok
𤠣	kholk
瘲	khoo
狏	khopd
𤺥	khor
疷	khpm
狴	khppg
狗	khpr
狍	khpru
狥	khpa
痻	khpa
瘦	khxe
癙	khxv
瘐	khxo
狷	khrb
猳	khrse
玁	khrrk
狚	kham
猂	khamj
癤	khal
獌	khawe
狠	khav
猲	khapv
猑	khapp
猖	khaa
猩	khahm
猸	khahu
猘	khhbn
猦	khhni
狅	khhg
獯	khhgf
獢	khhkb
猁	khhdn
奅	khhl
瘤	khhw
猈	khhwj
狢	khher
猏	khhs
猏	khhsb
猵	khhsb
獥	khhsk
痺	khhj
狧	khhjr
狌	khhqm
獋	khhuj
狐	khhvo
獀	khhxe
獡	khhxf
猊	khhxu
獅	khhrb
𤠒	khhrk
狛	khha
獆	khhaj
獔	khhaj
猈	khhhj
獴	khtbo
猐	khtgu
獚	khtlc
猫	khtw
玂	khtjl
獲	khtoe
猶	khtcw
獛	khtco
獈	khtct
獾	khtrg
猎	khta
獏	khtak
獦	khtav
疳	ktm
瘎	ktmv
癀	ktmc
痶	ktbc
瘽	ktlm
癘	ktwb
癑	ktwv
瘔	ktjr
痒	ktq
羍	ktq
瘥	ktqm
瘚	ktuo
癱	ktog
癢	ktov
瘩	ktor
瘼	ktak
木	d
本	dm
杢	dm
杠	dm
枟	dmmi
橱	dmmi
杇	dmms
柰	dmmf
杬	dmmu
桭	dmmv
欐	dmmp
梧	dmmr
桎	dmig
榗	dmia
橒	dmbi
檽	dmbb
欛	dmbb
㮕	dmbk
栭	dmbl
檑	dmbw
櫌	dmbe
樗	dmbs
欞	dmbo
槓	dmbc
櫺	dmbr
朾	dmn
栵	dmnn
桏	dmnl
柯	dmnr
枉	dmg
櫉	dmgi
櫮	dmgr
梇	dmgt
杅	dmd
櫪	dmdm
椏	dmlm
梗	dmlk
橊	dmlw
桺	dmls
橿	dmwm
橝	dmwj
標	dmwf
槱	dmwf
楆	dmwv
檟	dmwc
極	dmem
翉	dmsmm
枙	dmsu
椓	dmso
杆	dmj
橄	dmjk
柾	dmym
杯	dmf
柸	dmfm
檷	dmfb
檦	dmfn
枰	dmfj
桮	dmfr
杌	dmu
榎	dmue
橬	dmua
桱	dmvm
枑	dmvm
槈	dmvi
朽	dmvs
舝	dmvvq
枒	dmvh
柄	dmob
栖	dmcw
梄	dmcw
柘	dmr
槅	dmrb
楅	dmrw
韋	dmrq
梪	dmrt
栢	dma
桓	dmam
櫪	dmhm
榞	dmhf
枅	dmt
𣗳	dmti
櫔	dmtb
橛	dmto
寸	di
𣏾	di
栤	dime
栨	dimo
棧	dii
樃	diib
榔	diil
槮	diih
榑	dibi
榳	ding
栐	dine
櫠	dine
櫥	digi
枤	dik
柭	dikk
桳	dikj
𣏞	diku
椮	dikh
𣟖	didr
槦	dilb
刌	diln
栦	dill
槺	dile
榶	dilr
㮼	dism
𣛮	dist
梂	dije
榊	difl
檪	diod
杙	dip
栻	dipm
樲	dipc
樚	dixp
梭	dice
枱	dir
棫	dirm
桹	diav
桙	dihq
槭	dihf
楲	dihv
椷	dihr
械	dit
樜	ditf
櫎	ditc
朿	db
枂	db
柤	dbm
査	dbm
枏	dbmm
𣏵	dbmm
楥	dbme
檼	dbmp
椇	dbmc
桐	dbmr
棚	dbb
栅	dbbm
柵	dbbm
榾	dbbb
橓	dbbq
楇	dbbr
桴	dbnd
橓	dbnq
椆	dbgr
橪	dbkf
棌	dbd
棘	dbdb
棗	dbdb
刺	dbln
棦	dbsd
棴	dbse
楎	dbjj
枣	dby
枬	dby
相	dbu
欋	dbug
檙	dbul
欔	dbue
櫾	dbuf
梘	dbuu
梖	dbuc
桵	dbv
榽	dbvk
僰	dbo
榣	dbou
棎	dbcd
櫻	dbcv
榠	dbac
槄	dbhx
柵	dbt
棡	dbtu
棢	dbtv
杛	dn
桅	dnmu
𣚦	dnii
桶	dnib
栘	dnin
杼	dnin
栁	dnil
桝	dniq
柕	dnih
桷	dnbg
槲	dnbj
檞	dnbq
杻	dng
𣕑	dngd
梴	dnkm
梃	dnkg
楗	dnkq
李	dnd
杍	dnd
槂	dndf
𣏺	dndu
橢	dnlb
樄	dnlw
櫓	dnwa
楹	dnst
揧	dnq
榤	dnqd
榒	dnyy
櫯	dnfd
㮀	dnue
杴	dno
楈	dnob
櫈	dnon
楑	dnok
橃	dnoe
橙	dnot
檐	dncr
欃	dnri
栬	dnau
梚	dnau
橡	dnao
橘	dnhb
楙	dnhd
楺	dnhd
极	dnhe
杜	dg
榼	dgit
柟	dgb
檮	dgni
桂	dgg
槸	dggi
橈	dggu
櫝	dgwc
𣙀	dgji
檣	dgow
樾	dgov
梽	dgp
棱	dgce
桔	dgr
檯	dgrg
榬	dgrv
樹	dgti
夬	dk
杕	dk
楕	dkmb
桍	dkms
整	dkmym
椅	dkmr
栯	dkb
桋	dkn
朹	dkn
枠	dknj
楏	dkgg
桸	dkkb
樉	dkkk
棥	dkkd
柨	dklb
刔	dkln
栫	dkld
朸	dks
栛	dkss
槬	dkso
枷	dksr
檶	dksr
槉	dkok
梜	dkoo
慗	dkp
憖	dkp
憗	dkp
㯂	dkpb
榝	dkce
樧	dkce
橑	dkcf
𣕧	dkrd
梑	dkhf
鴂	dkhaf
鷘	dkhaf
林	dd
禁	ddmmf
辳	ddmmv
𨤳	ddmwg
椲	ddmq
𧯴	ddmrt
村	ddi
椘	ddino
麓	ddixp
栜	ddb
鬰	ddbuh
鬱	ddbuh
棾	ddbhn
梦	ddni
㯬	ddnkq
郴	ddnl
楚	ddnyo
埜	ddg
壄	ddg
樊	ddk
礬	ddkmr
蠜	ddkli
攀	ddkq
森	ddd
㯲	dddf
檚	dddo
梀	ddl
楋	ddln
𣙙	ddlk
樕	ddlo
櫴	ddlc
棟	ddw
榃	ddw
欝	ddwli
楝	ddwf
櫇	ddec
樷	ddsje
枺	ddj
焚	ddf
燓	ddf
婪	ddv
棽	ddoin
棶	ddoo
懋	ddp
𢡟	ddp
棼	ddcsh
楂	ddam
材	ddh
㯄	ddhmu
梵	ddhni
檒	ddhni
柀	ddhe
彬	ddhh
束	dl
頼	dlmbc
棑	dlmy
桃	dlmo
𣑯	dlmo
樻	dlmc
螙	dlii
柍	dlbk
枕	dlbu
欶	dlno
勅	dlks
鶒	dlksf
梊	dld
椞	dld
梙	dll
蜤	dllmi
剌	dlln
柫	dlln
杊	dlll
樓	dllv
柚	dlw
柛	dlwl
梬	dlws
樓	dlwv
栧	dlwp
棣	dle
賴	dlshc
辢	dlytj
櫢	dlvk
敕	dlok
惁	dlp
橚	dlx
棩	dlxl
柹	dlxh
𠵍	dlr
晳	dla
皙	dlha
鵣	dlhaf
東	dw
椳	dwmv
槶	dwim
𣖜	dwb
梩	dwg
栶	dwk
棵	dwd
梱	dwd
柙	dwl
欏	dwlg
楞	dwls
檡	dwlj
檌	dwly
檈	dwlv
櫑	dwww
欙	dwwf
檲	dwji
樌	dwjc
棝	dwjr
栂	dwyi
柬	dwf
樏	dwvf
楐	dwol
榲	dwot
楒	dwp
柶	dwc
棞	dwhd
鶇	dwhaf
鶫	dwhaf
頗	dembc
皯	demj
杈	dei
樑	deid
皹	debjj
㓟	deln
𣜖	deem
槡	deed
棳	deee
厀	desl
㿹	deygq
桫	defh
皰	depru
㭼	dea
栩	dsmm
樳	dsmi
楃	dsmg
櫂	dsmg
框	dsmg
梫	dsme
𣝦	dsmj
棖	dsmv
柌	dsmr
槢	dsma
樛	dsmh
檻	dsmt
梕	dsip
檻	dsit
樼	dsnd
柩	dsno
枢	dsk
桾	dskr
栕	dsll
榧	dsly
櫃	dslc
㭱	dswl
欖	dswu
欘	dsei
樫	dseg
樨	dseq
柜	dss
梮	dssr
栮	dsj
椰	dsjl
棷	dsje
欇	dsjj
椐	dsjr
梛	dsql
榪	dsqf
榍	dsfb
杞	dsu
𣜠	dsuf
梞	dsup
愸	dsp
柅	dsp
檉	dsrg
檘	dsrj
樞	dsrr
椻	dsav
朷	dsh
杒	dshi
梶	dshu
柖	dshr
榐	dstv
𣘗	dstr
𣖕	dstt
末	dj
楦	djmm
棕	djmf
梡	djmu
椗	djmo
榢	djmo
檳	djmc
槫	djii
橞	djip
杮	djb
植	djbm
椬	djbm
桲	djbd
楠	djbj
檫	djbf
欜	djbv
槙	djbc
椀	djnu
杖	djk
栲	djks
栳	djkp
槣	djkr
楮	djka
棲	djlv
枝	dje
橶	djji
檊	djjj
櫶	djqp
榟	djyj
桉	djv
樎	djoa
柁	djp
櫁	djpi
橣	djpb
檸	djpn
樒	djpu
榰	djpa
柼	djc
椌	djcm
榨	djcs
榕	djcr
枯	djr
楜	djrb
橭	djrj
棺	djrr
楁	djhr
枿	djt
𣟂	djti
橨	djtc
杽	dq
棈	dqmb
榡	dqmf
樍	dqmc
韍	dqikk
韗	dqbjj
韜	dqbhx
郼	dqnl
韖	dqnhd
韥	dqgwc
楱	dqkk
榛	dqkd
棒	dqkq
樁	dqkx
椿	dqka
韎	dqdj
韣	dqwli
韞	dqwot
韠	dqwtj
韔	dqsmv
韌	dqshi
槥	dqjm
韢	dqjip
梆	dqjl
櫘	dqjp
韕	dqyrd
韒	dqfb
枎	dqo
韐	dqomr
槻	dqou
櫕	dqoc
䪖	dqoae
韘	dqptd
楔	dqhk
韟	dqhaj
韡	dqtmj
韚	dqtlj
韤	dqtwi
韝	dqttb
朴	dy
櫏	dymu
檅	dymh
棛	dyib
𣘚	dyij
梳	dyiu
樴	dyia
橀	dyit
楴	dybb
檛	dybb
榜	dybs
櫳	dybp
楨	dybc
樋	dynb
橠	dynv
柱	dyg
橽	dygq
𣐀	dyk
楌	dykh
橔	dydk
槨	dydl
櫬	dydu
杫	dylm
柿	dylb
檀	dywm
樐	dywi
檁	dywd
櫰	dywv
榱	dywv
椸	dysd
棜	dysy
檹	dysr
枓	dyj
槤	dyjj
椒	dyfe
樆	dyub
橀	dyut
杧	dyv
槒	dyvw
核	dyvo
棭	dyok
椊	dyoj
樝	dypm
榩	dypk
橴	dypf
椃	dypu
櫨	dypt
櫅	dyx
樀	dycb
校	dyck
枮	dyr
槁	dyrb
梈	dyrn
楟	dyrn
椁	dyrd
椋	dyrf
欀	dyrv
檺	dyro
櫧	dyra
槕	dyad
棹	dyaj
杭	dyhn
枋	dyhs
槰	dyhj
𣐿	dyhv
槌	dyhr
楌	dyhh
柆	dyt
橦	dytg
樟	dytj
櫣	dytj
梓	dytj
樈	dytu
檤	dytu
椄	dytv
檖	dyto
檍	dytp
棓	dytr
㭂	df
杰	df
𣏹	df
╡	df
桄	dfmu
梢	dfb
𣙟	dfbb
樘	dfbg
橖	dfbd
檔	dfbw
𣛟	dfbq
欓	dfbf
㭻	dfbr
橕	dfbh
歀	dfno
橉	dfdq
楼	dfdv
隸	dfle
柈	dfq
棬	dfqu
棪	dff
橩	dffn
𣞁	dffd
𣟕	dffd
橯	dffs
檆	dffr
櫿	dffr
杪	dfh
札	du
椯	dumb
榿	dumt
蚻	dulmi
柮	duu
紮	duvif
欈	duob
梣	duon
槯	duog
想	dup
椶	duce
梤	duch
𣗏	duhj
梉	dvmg
㰘	dvmt
𣟗	dvmt
機	dvii
櫟	dvid
柪	dvis
椂	dvne
椽	dvno
朻	dvl
檰	dvfb
櫞	dvfo
檵	dvvi
樔	dvvd
椔	dvvw
欚	dvoi
朲	do
𣏴	domm
棆	domb
榆	domn
栓	domg
栣	domg
楩	domk
梌	domd
楡	domv
検	domo
檢	domo
梹	domc
㭘	domr
檜	doma
栰	doi
櫼	doim
柃	doii
枔	doin
猌	doik
棯	doip
槍	doir
梒	doir
枘	dob
榷	dobg
栴	doby
賚	dobuc
杚	don
郲	donl
椎	dog
欆	doge
檇	dogs
榫	dogj
樵	dogf
枚	dok
権	dokg
勑	doks
椥	dokr
柎	dodi
樇	dolb
樤	dold
𣘀	dolh
梅	dowy
桼	doe
柞	dos
杵	doj
檎	doyb
來	doo
桽	doog
杹	dop
柂	dopd
椱	doae
𠌊	doau
鶆	dohaf
橅	dotf
𣗍	dotc
朼	dp
杺	dp
枃	dpmm
杓	dpi
构	dpi
楤	dpkp
杝	dpd
椈	dpfd
杶	dpu
枇	dpp
梐	dppg
㰑	dppd
楷	dppa
枸	dpr
枹	dpru
栒	dpa
栺	dpa
柲	dph
榓	dpht
枻	dpt
楪	dptd
朳	dc
枍	dcms
松	dci
棇	dcip
梯	dcnh
橧	dcwa
枌	dcsh
㭲	dcor
柗	dcr
梲	dcru
棁	dcru
檭	dcav
椕	dchd
杏	dr
╣	dr
枵	drms
㯝	drmr
梋	drb
𣑐	drlb
椵	drse
楫	drsj
枴	drsh
檝	drji
椵	drye
𣏌	dru
枳	drc
橾	drrd
㮙	drrs
樿	drrj
楍	drrr
榀	drrr
桯	drhg
柺	drhs
柷	drhu
梠	drhr
杳	da
查	dam
柦	dam
棏	dami
桿	damj
楊	damh
楖	dail
概	daiu
榅	dabt
椚	dan
橌	danb
橍	dang
㯗	dand
欄	danw
櫩	danx
櫊	danr
櫚	danr
橺	dana
榯	dagi
槾	dawe
榻	dasm
樶	dase
榥	dafu
杷	dau
櫭	daum
根	dav
楬	dapv
棍	dapp
椙	daa
楣	dahu
才	dh
╢	dh
析	dhml
栃	dhms
柝	dhmy
栀	dhmu
梔	dhmu
梹	dhmc
櫆	dhij
柉	dhio
鼒	dhbul
桖	dhbt
机	dhn
楓	dhni
杋	dhni
𣑲	dhnb
杸	dhne
檓	dhge
櫄	dhgf
㭠	dhgu
梏	dhgr
枖	dhk
橋	dhkb
桥	dhkl
楌	dhkh
柇	dhd
棅	dhdl
橎	dhdw
楸	dhdf
楀	dhlb
𣔙	dhlo
橮	dhlc
櫍	dhlc
椑	dhwj
樬	dhwp
皮	dhe
板	dhe
桻	dhej
栙	dheq
柊	dhey
格	dher
楄	dhsb
梸	dhsn
檄	dhsk
槴	dhsu
杄	dhj
棰	dhjm
株	dhjd
椴	dhje
楯	dhju
栝	dhjr
櫡	dhja
栍	dhqm
枆	dhqu
柣	dhqo
樦	dhyg
榹	dhyu
槐	dhui
櫋	dhus
橰	dhuj
橇	dhuu
欑	dhuc
枊	dhvl
柧	dhvo
桁	dhon
椼	dhon
樅	dhoo
𣠺	dhoo
杔	dhp
柢	dhpm
槪	dhpu
桰	dhpr
棔	dhpa
橁	dhpa
桕	dhx
棿	dhxu
楰	dhxo
櫸	dhcq
欅	dhcq
桘	dhrr
柏	dha
棉	dhab
楻	dhag
櫛	dhal
槔	dhaj
槹	dhaj
樢	dhaf
梎	dhap
榭	dhhi
柳	dhhl
榴	dhhw
椑	dhhj
鸉	dhhaf
杉	dhhh
檱	dhtc
柑	dtm
楳	dtmd
樺	dtmj
椹	dtmv
橫	dtmc
棋	dtmc
𣞢	dtif
𣔰	dtio
𣕚	dtih
𣙷	dtit
椾	dtbn
櫒	dtbf
𣜭	dtbf
檬	dtbo
檥	dtgi
𣖙	dtgk
様	dtge
樣	dtge
㰕	dtgs
榚	dtgf
檨	dtgo
橏	dtgr
栚	dtk
楉	dtkr
槿	dtlm
樠	dtlb
楧	dtlk
㮖	dtlj
櫹	dtlx
橫	dtlc
樽	dtwi
櫗	dtwi
橂	dtwk
𣜃	dtwf
檂	dtwv
横	dtwc
槽	dtwa
欂	dtei
榵	dtsj
櫙	dtsr
𣜯	dtjm
㯴	dtjr
楛	dtjr
样	dtq
槎	dtqm
欁	dtvd
𣗎	dtog
檴	dtoe
𣞼	dtov
椛	dtop
榙	dtor
𣚭	dtpd
𣜿	dtpd
檧	dtpp
槆	dtpa
槏	dtxc
栱	dtc
樭	dtcg
檏	dtcd
楢	dtcw
欉	dtce
櫀	dtcf
樸	dtco
榏	dtct
權	dtrg
㯳	dtrk
棤	dta
橗	dtab
模	dtak
欗	dtaw
樥	dthj
栟	dtt
構	dttb
椪	dttc
丿	l
中	l
║	l
丨	l
肀	l
衤	l
丄	lm
韭	lmmm
裖	lmmv
襹	lmmp
虫	lmi
襦	lmbb
袻	lmbl
貴	lmbuc
袔	lmnr
衧	lmd
裲	lmlb
劃	lmln
褾	lmwf
褼	lmwu
非	lmsy
剕	lmsyn
衦	lmj
卝	lmy
羋	lmyq
剕	lmyyn
襧	lmfb
賮	lmfbc
盡	lmfbt
兆	lmuo
鴵	lmuof
覜	lmuou
頫	lmuoc
褥	lmvi
北	lmp
邶	lmpnl
袥	lmr
褔	lmrw
裋	lmrt
袹	lma
䪤	lmhdw
虹	lim
蟵	limmi
蚖	limmu
蜄	limmv
蛭	limig
蠕	limbb
蝡	limbk
蝢	limbc
虰	limn
蛚	limnn
蚵	limnr
蚟	limg
虶	limd
蜽	limlb
蝒	limwl
蟫	limwj
螵	limwf
虷	limj
虾	limy
蚽	limfm
蚲	limfj
蛵	limvm
蚜	limvh
蛃	limob
螎	limrb
蝠	limrw
蛨	lima
螈	limhf
蠣	limtb
蟩	limto
螂	liiil
䗚	liibi
蛂	liikk
蟡	liikf
蚘	liiku
螗	liilr
蜅	liijb
蛷	liije
蛖	liiuh
蠀	liioc
螰	liixp
蜮	liirm
蜋	liiav
襂	liih
蛑	liihq
䗩	liihf
蝛	liihv
蟅	liitf
蝷	liitu
蠊	liitc
蚏	lib
蛆	libm
蚦	libmm
蝯	libme
螖	libbb
蝸	libbr
蜉	libnd
蜩	libgr
蛶	libdi
蚒	liby
蠷	libug
蠼	libue
蜆	libuu
蛽	libuc
螇	libvk
褦	libp
蠳	libcv
螟	libac
蛫	linmu
蛹	linib
蠏	linbq
蝜	linbc
蜒	linkm
蜓	linkg
虸	lind
蜢	lindt
蚓	linl
蝑	linob
蟾	lincr
蟓	linao
𧑐	linhb
蝚	linhd
蜭	linhx
𧉧	ligi
蠘	ligig
蚺	ligb
蛙	ligg
蟯	liggu
蛣	ligr
蟢	ligrr
蟛	ligth
蛕	likb
蛦	likn
蝰	likgg
袚	likk
𧊀	liksr
螏	likok
蛺	likoo
螮	likpb
蟟	likcf
蚞	lid
蚗	lidk
蝲	lidln
蝀	lidw
蜙	lidci
蜥	lidhl
蚾	lidhe
蚛	lil
蟲	lilii
蠱	lilit
蟰	lilll
蝂	lille
螻	lillv
蚰	lilw
𧊋	lilwl
螻	lilwv
蜵	lilxl
蟈	liwim
蝟	liwb
䘃	liwgg
蟔	liwgf
蜾	liwd
蠋	liwli
蠌	liwlj
蠉	liwlv
蠝	liwww
蜖	liwyl
螺	liwvf
蝹	liwot
蛔	liwr
蜠	liwhd
蝃	lieee
蟝	liesd
蛡	lismm
蟳	lismi
蠗	lismg
蟉	lismh
蠮	lisem
蠾	lisei
蚷	liss
蜛	lisjr
螞	lisqf
蚇	liso
蚭	lisp
蟶	lisrg
蝘	lisav
虭	lish
𧋦	lishu
蛁	lishr
螾	lijm
蝖	lijmm
蠙	lijmc
蠘	lijig
蟪	lijip
補	lijb
蝻	lijbj
蜿	lijnu
蛯	lijkp
蝫	lijka
蜨	lijlo
蛼	lijwj
蚑	lije
褲	lijj
螹	lijjl
䘆	lijqp
螛	lijqr
蛇	lijp
螲	lijcg
蛄	lijr
蝴	lijrb
䖳	lijhp
蟦	lijtc
蜻	liqmb
蝳	liqmy
螓	liqkd
蝽	liqka
蚌	liqj
蚨	liqo
虲	liy
𧏿	liymo
蟀	liyij
蟙	liyia
螃	liybs
蠬	liybp
蛀	liyg
蟽	liygq
蚊	liyk
蟺	liywm
蝣	liysd
蜨	liyso
蚪	liyj
螭	liyub
虻	liyv
蚿	liyvi
蜶	liyoj
蟕	liypb
蠦	liypt
蠐	liyx
螪	liycb
蛟	liyck
蛅	liyr
蝏	liyrn
蜳	liyrd
𧐢	liyru
蠰	liyrv
蠔	liyro
蠩	liyra
螁	liyav
蚢	liyhn
蚄	liyhs
蟑	liytj
蛸	lifb
螳	lifbg
蟷	lifbw
蜷	lifqu
蠑	liffd
蟧	liffs
虬	liu
𧍒	liumb
螘	liumt
蜬	liune
䖦	liuu
蠵	liuob
蝬	liuce
蟣	livii
蚴	livis
蝝	livno
虯	livl
𧖣	livfi
蠟	livvv
蚯	liom
蜦	liomb
蝓	liomn
𧊲	liomg
蜍	liomd
蛤	liomr
蛉	lioii
蚙	lioin
蚮	lioip
蛿	lioir
螥	lioir
蚋	liob
虼	lion
蜁	liono
蜼	liog
蟭	liogf
蜘	liokr
蚹	liodi
螩	liold
蚧	lioll
蚱	lios
蛜	liosk
蠄	lioyb
蟘	liopc
蝮	lioae
蚐	lipmm
虳	lipi
虵	lipd
蜪	lipou
蚍	lipp
蜌	lippg
蝔	lippa
蚼	lipr
蝶	liptd
蚣	lici
螉	licim
蚥	lick
蚡	licsh
蛻	licru
蜕	licru
蜎	lirb
𧊅	lirks
蝇	lirwu
蝦	lirse
蟤	liruc
蜈	lirvk
蠅	lirxu
蟬	lirrj
蚎	lia
蝭	liamo
蝪	liamh
蝍	liail
蝐	liabu
𧒄	liana
蟃	liawe
蚆	liau
蛝	liav
蠍	liavo
蝎	liapv
蜫	liapp
蜴	liaph
蝞	liahu
蚚	lihml
蚸	lihmy
螝	lihi
虮	lihn
蟍	lihnd
𧊶	lihnd
蟜	lihkb
蜊	lihdn
蟠	lihdw
蝌	lihdj
蜲	lihdv
蟋	lihdp
蝺	lihlb
蜱	lihwj
蟌	lihwp
蜂	lihej
蚱	lihs
蝙	lihsb
蜧	lihsk
蚅	lihsu
蝩	lihjg
蛛	lihjd
𧎚	lihje
蛞	lihjr
蛾	lihqi
蚝	lihqu
蛈	lihqo
螔	lihyu
螝	lihui
螑	lihuk
螅	lihup
蛌	lihvo
蚔	lihvp
虴	lihp
蚳	lihpm
螋	lihxe
蜺	lihxu
螄	lihrb
螐	lihrf
蝗	lihag
蟂	lihad
蜱	lihhj
牌	lihhj
蚶	litm
蜞	litmc
蟒	litit
褯	litb
蠓	litbo
蟻	litgi
蜣	litgu
蟮	litgr
蠎	litkt
螼	litlm
蟎	litlb
蝧	litlk
蠨	litlx
蟥	litlc
蛐	litw
蠛	litwi
𧒆	litwi
蠇	litwb
螬	litwa
蛘	litq
蝆	litq
螆	litvi
蜹	litob
蠖	litoe
蠂	litpd
螊	litxc
蟖	litcl
蝤	litcw
蠸	litrg
蜡	lita
蟆	litak
蛢	litt
巾	lb
袓	lbm
帪	lbmmv
衻	lbmmv
幁	lbmbc
幊	lbmbc
帄	lbmn
褑	lbme
幅	lbmrw
帞	lbma
帴	lbii
幓	lbiih
幮	lbigi
帗	lbikk
幎	lbbac
幍	lbbhx
鄁	lbnl
幨	lbncr
幬	lbgni
裯	lbgr
央	lbk
幃	lbdmq
帓	lbdj
帔	lbdhe
帎	lblbu
幗	lbwim
𢃇	lbwg
幄	lbsmg
帳	lbsmv
𢄪	lbsmh
𢁾	lbshr
幈	lbstt
幏	lbjmo
帵	lbjnu
帾	lbjka
褌	lbjj
幰	lbjqp
幩	lbjtc
幘	lbqmc
㠸	lbqo
袇	lby
幟	lbyia
幀	lbybc
帖	lbyr
𢅳	lbyhc
幢	lbytg
幛	lbytj
帹	lbytv
帩	lbfb
冘	lbu
农	lbv
帢	lbomr
帷	lbog
幠	lbotf
帉	lbcsh
帨	lbcru
幧	lbrrd
幝	lbrrj
帽	lbabu
幔	lbawe
幜	lbayf
幌	lbafu
帊	lbau
幆	lbapv
𢃼	lbahu
㠶	lbhn
帆	lbhni
幡	lbhdw
幒	lbhwp
帲	lbhjj
帙	lbhqo
帕	lbha
幯	lbhal
盅	lbt
帺	lbtmc
幪	lbtbo
幭	lbtwi
幞	lbtco
𠗟	lbtco
幙	lbtak
帡	lbtt
刂	ln
鬥	ln
鬫	lnmjk
牐	lnmjx
鬪	lnmti
襁	lnii
𧚔	lnib
牗	lnilb
鬬	lnbml
覑	lnbuu
費	lnbuc
鬮	lnnxu
艴	lnnau
刜	lnln
鬧	lnylb
鬦	lnyj
襏	lnoe
襜	lncr
鬭	lnrml
襐	lnao
牕	lnhwp
衱	lnhe
𧘌	lnhs
牑	lnhsb
鬩	lnhxu
鬨	lntc
袪	lgi
袡	lgb
袿	lgg
褹	lggi
褂	lggy
襓	lggu
畫	lgwm
襩	lgwc
裬	lgce
袺	lgr
褤	lgrv
襭	lgrc
書	lga
晝	lgam
史	lk
袏	lkm
袴	lkms
裿	lkmr
襫	lkma
𧘹	lki
盎	lkbt
袸	lkld
裺	lklu
裌	lkoo
𧜵	lkpb
𧙗	lkr
鴦	lkhaf
褘	ldmq
襋	ldbb
袂	ldk
襻	lddq
襟	lddf
袜	ldj
被	ldhe
串	ll
衶	ll
片	llml
裶	llmy
牋	llii
牗	llilb
衴	llbu
覑	llbuu
弗	lln
歗	llno
牘	llgwc
朄	lldwf
川	lll
褸	lllv
順	lllc
袖	llw
丳	llww
牊	llshr
牓	llybs
𤗈	llytv
粛	llfl
牉	llfq
婁	llv
牏	llomn
患	llp
褙	llpb
牎	llpkp
牒	llptd
裫	llxl
暢	llamh
𣈱	llaph
牌	llhwj
牕	llhwp
版	llhe
牖	llhsb
牐	llhjx
由	lw
頔	lwmbc
畁	lwml
甹	lwmvs
冑	lwb
胄	lwb
邮	lwnl
裡	lwg
裀	lwk
裸	lwd
裍	lwd
申	lwl
𧝁	lwlm
襡	lwli
𧟌	lwlg
襗	lwlj
襬	lwlp
电	lwu
褞	lwot
曳	lwp
隶	le
衩	lei
褬	leed
裰	leee
冂	ls
韭	lsmm
襑	lsmi
褶	lsma
襤	lsmt
襤	lsit
裙	lskr
𧜶	lseg
裾	lsjr
褗	lsav
初	lsh
袑	lshr
𦘒	lj
襶	ljic
褚	ljka
𧙕	ljd
衼	lje
袉	ljp
袕	ljc
褣	ljcr
𧙖	ljr
聿	lq
裱	lqmv
襀	lqmc
衋	lqmat
衭	lqo
褉	lqhk
补	ly
褃	lymb
㻗	lymgi
猆	lyik
裗	lyiu
褅	lybb
𦚯	lybu
襱	lybp
𩇫	lynd
𧞅	lygq
奜	lyk
棐	lyd
襯	lydu
𧘲	lylm
蜚	lylmi
襢	lywm
翡	lysmm
輩	lyjwj
褳	lyjj
斐	lyyk
裴	lyyhv
褵	lyub
婓	lyv
袨	lyvi
餥	lyoiv
悲	lyp
裭	lypu
䙛	lycv
袩	lyr
褪	lyav
㹃	lyhq
靟	lyhqu
襚	lyto
襒	lfbk
襠	lfbw
褛	lfdv
袢	lfq
裷	lfqu
裧	lff
儿	lu
䪴	lumbc
瓭	lumvn
邥	lunl
兓	lulsu
沊	lue
熈	luf
袦	luu
鴆	luhaf
甊	lvmvn
𧝞	lvii
袎	lvis
胤	lvbu
褖	lvno
數	lvok
袽	lvr
氀	lvhqu
𤬏	lvhvo
鷜	lvhaf
褕	lomn
袵	lomg
襝	lomo
袷	lomr
襘	loma
襳	loim
袊	loii
衿	loin
袱	loik
衲	lob
襍	logd
鼗	logte
衸	loll
袮	lof
袘	lopd
褓	lord
複	loae
袵	lohg
袗	lohh
襥	loto
忠	lp
丠	lpm
袀	lpmm
背	lpb
衪	lpd
冀	lpwtc
𠤖	lpq
裪	lpou
袧	lpr
袍	lpru
袐	lph
兠	lphu
袣	lpt
褋	lptd
肅	lx
歗	lxno
𠂔	lxh
鷫	lxhaf
衳	lci
鄪	lcnl
衯	lcsh
裕	lcor
裞	lcru
裎	lrmg
裐	lrb
襈	lrvc
襙	lrrd
襌	lrrj
裎	lrhg
旧	la
甴	la
衵	la
袒	lam
褆	lamo
𢅺	laitb
襉	lanb
襴	lanw
襇	lana
褟	lasm
襊	lase
裉	lav
褐	lapv
裩	lapp
裼	laph
裮	laa
児	lahu
襮	late
长	lhmo
襖	lhbk
裇	lhbt
凣	lhn
衽	lhg
袄	lhk
襎	lhdw
𧞄	lhws
裨	lhwj
袶	lheq
袼	lher
褊	lhsb
袾	lhjd
袟	lhqo
褫	lhyu
襣	lhul
襸	lhuc
衹	lhvp
褷	lhoo
袛	lhpm
襷	lhcj
袙	lha
裨	lhhj
衫	lhhh
褀	ltmc
襺	ltbi
襼	ltgi
襔	ltlb
襪	ltwi
襛	ltwv
褿	ltwa
褡	ltor
襆	ltco
襽	ltaw
田	w
囩	wmmi
园	wmmu
圄	wmmr
町	wmn
囯	wmg
国	wmgi
畀	wml
㓻	wmln
圂	wmso
囸	wmym
畏	wmv
圎	wibc
歜	wino
畎	wik
圃	wijb
圗	wijw
斀	wiye
畯	wice
囼	wir
㽣	wirm
國	wirm
㽙	wihu
鸀	wihaf
胃	wb
顒	wbmbc
朙	wbb
㘥	wbuf
愚	wbp
墅	wng
囝	wnd
畂	wno
里	wg
圔	wgit
畘	wgb
疇	wgni
野	wgnin
畦	wgg
畤	wgdi
黑	wgf
黒	wgf
墨	wgfg
園	wgrv
圉	wgtj
因	wk
龱	wk
畸	wkmr
囿	wkb
盢	wkbt
欭	wkno
男	wks
恩	wkp
果	wd
困	wd
顆	wdmbc
圍	wdmq
団	wdi
夥	wdnin
敤	wdye
团	wdh
褁	wdhv
甲	wl
罡	wlmym
罘	wlmf
罽	wlmfn
圚	wlmc
睘	wlmrv
罷	wlibp
羆	wlipf
罭	wlirm
罝	wlbm
禺	wlbi
罦	wlbnd
買	wlbuc
罞	wlnih
罢	wlgi
罣	wlgg
罫	wlggy
瞏	wlgrv
圕	wlga
睪	wlgtj
罨	wlklu
罧	wldd
罒	wll
罪	wllmy
𠝹	wlln
甽	wlll
奰	wlwwk
𦌵	wlwww
罳	wlwp
罼	wlwtj
罬	wleee
罵	wlsqf
罻	wlsfi
置	wljbm
罱	wljbj
署	wljka
罟	wljr
詈	wlymr
罜	wlyg
罸	wlyri
罰	wlyrn
罩	wlyaj
罿	wlytg
罯	wlyta
羅	wlvfg
羉	wlvff
罺	wlvvd
眾	wlooo
蜀	wlpli
罹	wlpog
罾	wlcwa
罥	wlrb
罠	wlrvp
罛	wlhvo
鴨	wlhaf
罶	wlhhw
羈	wltjf
羇	wltjr
羃	wltab
畕	ww
圛	wwlj
圜	wwlv
畾	www
疉	wwwm
疊	wwwm
壘	wwwg
櫐	wwwd
壨	wwwwg
纍	wwwf
罍	wwwu
𨯔	wwwc
礨	wwwr
鸓	wwhaf
囦	we
畷	weee
疁	wsmh
嬲	wsvws
毌	wj
毋	wj
團	wjii
貫	wjbuc
畹	wjnu
歝	wjno
斁	wjok
固	wjr
毋	wjh
鷝	wjha
鷝	wjhaf
鸅	wjhaf
圊	wqmb
𤲟	wqmb
畉	wqo
圁	wymr
母	wyi
貫	wybuc
㝀	wynd
𡥘	wynd
図	wyk
囬	wyyl
甿	wyv
畡	wyvo
毑	wypd
㽘	wyhn
囥	wyhn
疃	wytg
╤	wf
黫	wfmwg
黖	wfmvu
黲	wfiih
默	wfik
黓	wfip
黢	wfice
黟	wfnin
黵	wfncr
黷	wfgwc
黠	wfgr
黤	wfklu
疄	wfdq
黕	wflbu
黰	wfjbc
黦	wfjnu
畔	wfq
圈	wfqu
圏	wfqu
𪐴	wfyg
黸	wfypt
點	wfyr
黥	wfyrf
黯	wfyta
黜	wfuu
黝	wfvis
黔	wfoin
黣	wfowy
黭	wfort
黗	wfpu
黚	wftm
黮	wftmv
圌	wumb
囡	wv
累	wvif
翾	wvsmm
圞	wvfd
圝	wvff
䴉	wvhaf
囚	wo
圇	womb
畭	womd
囹	woii
畋	wok
界	woll
畍	woll
畮	wowy
慁	wop
囮	wop
畛	wohh
思	wp
畇	wpmm
顋	wpmbc
囤	wpu
毗	wpp
毘	wpp
囫	wphh
四	wc
囧	wcb
囶	wcg
圀	wcys
畟	wche
鷶	wchaf
回	wr
╦	wr
㘣	wrb
圓	wrbc
圖	wryw
囻	wrvp
╥	wh
畖	whio
𡇙	whnd
𤴆	whgi
囷	whd
畈	whe
略	wher
畧	wher
畽	whjg
𤳉	wtlo
畢	wtj
𤳙	wtju
異	wtc
囲	wtt
畊	wtt
水	e
氵	e
氺	e
江	em
沄	emmi
污	emms
沶	emmf
沅	emmu
浱	emmv
灑	emmp
澒	emmc
浯	emmr
洷	emig
溍	emia
𤅷	embm
澐	embi
澪	embi
瀜	embi
濡	embb
灞	embb
瀖	embg
渜	embk
洏	embl
㵢	embw
瀀	embe
灀	embu
湏	embc
𤅟	embr
汀	emn
洌	emnn
河	emnr
汪	emg
洅	emgb
涯	emgg
潖	emgu
𣾏	emgr
濏	emgh
汙	emd
瀝	emdm
𤃉	emdp
𣵾	emlm
沞	emlb
浭	emlk
澑	emlw
沔	emls
湮	emwg
湹	emwg
溧	emwd
潥	emwd
湎	emwl
潭	emwj
漂	emwf
涙	emsk
涿	emso
汗	emj
澉	emjk
汚	emjs
泟	emym
漹	emyf
𤅜	emfi
濔	emfb
泙	emfj
灊	emub
潛	emua
涇	emvm
沍	emvm
溽	emvi
漘	emvb
溼	emvg
汅	emvs
滣	emvr
瀦	emoa
汚	emps
酒	emcw
洒	emcw
沯	emr
沰	emr
滆	emrb
湢	emrw
𣸰	emru
滒	emrr
浢	emrt
洦	ema
洹	emam
瀝	emhm
源	emhf
鴻	emhf
汧	emt
㴻	emti
濿	emtb
叉	ei
戏	ei
淺	eii
滲	eiih
溥	eibi
泳	eine
汱	eik
沷	eikk
溈	eikf
沋	eiku
渗	eikh
梁	eid
灖	eidy
蚤	eilmi
滽	eilb
洲	eill
漮	eile
溏	eilr
瀍	eiwg
沪	eis
浦	eijb
浗	eije
沭	eijc
浅	eiq
灋	eifi
粱	eifd
浝	eiuh
泧	eiv
涘	eiok
澬	eioc
浳	eipb
瀌	eipf
灋	eixi
漉	eixp
浚	eice
治	eir
淢	eirm
澸	eirp
浪	eiav
洠	eihq
滅	eihf
沇	eihu
減	eihr
渡	eite
瀇	eitc
濂	eitc
沮	ebm
湲	ebme
濦	ebmp
洞	ebmr
淜	ebb
滑	ebbb
涭	ebbe
漞	ebbu
渦	ebbr
浮	ebnd
𡒗	ebg
淍	ebgr
鸂	ebkf
𣶶	ebd
浖	ebdi
𣺉	ebdd
灂	ebwi
淨	ebsd
渾	ebjj
𣂎	ebyj
浵	ebyh
泪	ebu
灈	ebug
濉	ebug
湨	ebuk
濎	ebul
涀	ebuu
覌	ebuu
浿	ebuc
淚	ebuc
渺	ebuh
浽	ebv
溪	ebvk
𣿀	eboe
漈	ebof
滛	ebou
慂	ebp
懣	ebp
懘	ebp
濺	ebci
測	ebcn
深	ebcd
浫	ebcj
瀴	ebcv
浻	ebcr
滘	ebcr
瀃	ebch
泂	ebr
淝	ebau
溟	ebac
淫	ebhg
潙	ebhf
沉	ebhu
滔	ebhx
㳑	ebt
泴	ebt
𣷣	ebtu
溺	enmm
瀰	enmb
渌	enme
洈	enmu
汐	eni
泓	eni
漒	enii
涌	enib
汿	enin
沀	enin
濥	enic
洺	enir
渙	enbk
湧	enbs
澥	enbq
盕	enbt
澦	ennc
沑	eng
涎	enkm
涏	enkg
𣶻	enkw
湕	enkq
染	end
汓	end
邓	enl
漋	enlm
瀡	enlb
滁	enld
泐	enls
㶏	enlp
濻	enlc
𣾂	enla
漁	enwf
瀂	enwa
沒	ene
洆	enem
浄	ensd
渳	ensj
漲	ensv
溋	enst
汛	enj
滐	enqd
𤄏	enff
涵	enue
欢	eno
湑	enob
湀	enok
潑	enoe
澄	enot
澹	encr
瀺	enri
浼	enau
潒	enao
潏	enhb
渘	enhd
汲	enhe
淊	enhx
圣	eg
坔	eg
頚	egmbc
法	egi
瀐	egim
溨	egid
溘	egit
潱	egbt
濤	egni
洼	egg
塣	egg
湗	eggi
澆	eggu
洔	egdi
瀔	egde
濲	egde
浾	eglc
瀆	egwc
滶	egsk
準	egj
瀫	egfe
濇	egow
淕	egcg
淩	egce
洁	egr
溒	egrv
𤂌	egrc
𤀺	egrr
澍	egti
涬	egtj
澎	egth
汏	ek
𣳇	ekm
洿	ekms
渏	ekmr
汰	eki
汯	eki
洧	ekb
洟	ekn
氿	ekn
汍	ekni
淆	ekkb
浠	ekkb
漺	ekkk
㳍	eklb
洊	ekld
淹	eklu
劝	eks
氻	eks
泇	eksr
渀	ekjt
洃	ekf
浹	ekoo
滯	ekpb
鋈	ekc
潦	ekcf
㵑	ekrc
漪	ekhr
潴	ekha
沐	ed
泍	edm
顙	edmbc
𣸑	edmd
湋	edmq
渿	edmf
对	edi
洓	edb
湘	edbu
盓	edbt
𤄄	ednf
塗	edg
溎	edgg
決	edk
淋	edd
潸	eddb
滼	eddn
漜	eddg
潹	eddd
澿	eddf
漤	eddv
𤂑	eddv
濋	eddo
灪	eddh
涑	edl
潄	edlk
漱	edlo
瀨	edlc
瀬	edlc
涷	edw
湅	edwf
沫	edj
𤄿	edvd
𣸯	edod
漆	edoe
𪆵	edof
淶	edoo
淞	edci
渣	edam
淅	edhl
波	edhe
湐	edha
涁	edhh
沖	el
渄	elmy
洮	elmo
潰	elmc
濜	elmt
渱	elim
灗	elim
泱	elbk
沈	elbu
垽	elg
壍	elg
澅	elgm
鼝	elgte
沸	elln
汌	elll
沜	elll
漊	ellv
漶	ellp
油	elw
涄	elws
洩	elwp
聻	elsj
津	elq
渊	elfl
嬱	elv
湚	elvu
潚	elx
淵	elxl
泲	elxh
𨮜	elc
魙	elhui
沺	ew
畓	ew
淠	ewml
渨	ewmv
溷	ewmo
漍	ewim
渭	ewb
歠	ewno
浬	ewg
潶	ewgf
洇	ewk
淉	ewd
涃	ewd
潿	ewdq
濁	ewli
湡	ewlb
瀱	ewln
澤	ewlj
澴	ewlv
潀	ewlo
𣽁	ewlo
濖	ewla
灅	ewwg
㵽	ewww
𣲷	ewe
涸	ewjr
溿	ewfq
漯	ewvf
泅	ewo
溫	ewot
㴓	ewp
泗	ewc
𣳉	ewc
洄	ewr
滭	ewtj
潩	ewtc
双	ee
汉	ee
𣲙	ee
沝	ee
碆	eemr
汊	eei
溞	eeii
叒	eee
淼	eee
叠	eeem
𣿫	eeem
桑	eeed
叕	eeee
涰	eeee
渁	eeee
剟	eeeen
敠	eeeee
敪	eeeee
鵽	eeeef
毲	eeeeu
欼	eeeeo
婆	eev
滩	eeog
錃	eec
涾	eea
濷	eetb
潯	esmi
漏	esmb
瀥	esmb
濯	esmg
洭	esmg
渥	esmg
浸	esme
濢	esmj
瀈	esmj
涱	esmv
瀷	esmc
泀	esmr
漝	esma
漻	esmh
濫	esmt
澀	esim
涊	esip
濫	esit
涮	esbn
潺	esnd
涒	eskr
渠	esd
洍	esll
㶊	eslc
瀶	eslr
灠	eswu
灟	esei
𣻹	eseg
𣿬	eseg
㵵	eseo
洰	ess
洱	esj
灄	esjj
涺	esjr
潳	esja
溤	esqf
灟	esyi
漽	esyq
𣻷	esfi
氾	esu
𤏁	esuf
淈	esuu
沢	eso
滙	esog
𣾀	esog
泥	esp
澱	esce
澼	esrj
漚	esrr
浘	eshu
沼	eshr
𣺹	estv
𣸹	estt
汁	ej
渲	ejmm
泞	ejmn
𣳿	ejmd
滱	ejme
淙	ejmf
浣	ejmu
淀	ejmo
𣺊	ejmo
濱	ejmc
演	ejmc
漙	ejii
𣽡	ejii
涋	ejik
潓	ejip
瀻	ejic
渽	ejir
沛	ejb
淔	ejbm
𣶺	ejbm
浡	ejbd
湳	ejbj
溹	ejbf
灢	ejbv
滇	ejbc
涴	ejnu
浤	ejki
涍	ejkd
洘	ejks
渚	ejka
沬	ejd
浨	ejd
漖	ejdk
渤	ejds
淒	ejlv
𣶏	ejlo
汥	eje
瀚	ejjm
潮	ejjb
漧	ejjn
漸	ejjl
澣	ejjj
濣	ejjj
𤃬	ejjc
瀗	ejqp
漃	ejye
滓	ejyj
洝	ejv
滨	ejoc
沱	ejp
澝	ejpb
𤀑	ejpb
濘	ejpn
滵	ejpu
淧	ejph
泬	ejc
涳	ejcm
潸	ejcb
漥	ejcg
湥	ejck
溛	ejco
溶	ejcr
沽	ejr
湖	ejrb
涫	ejrr
濵	ejac
瀋	ejhw
浶	ejhq
瀉	ejhf
滨	ejhc
泋	ejt
瀽	ejto
濆	ejtc
淸	eqmb
清	eqmb
溸	eqmf
漬	eqmc
𤂅	eqbi
瀞	eqbd
濪	eqbu
堻	eqg
涛	eqki
湊	eqkk
溱	eqkd
溙	eqke
淎	eqkq
湷	eqka
洡	eqd
湱	eqjr
濽	eqoc
湁	eqor
潜	eqoa
浙	eqhl
潔	eqhf
澁	eymm
𤀹	eymu
泚	eymp
濊	eymh
淯	eyib
流	eyiu
渧	eybb
濄	eybb
灕	eybg
澈	eybk
滂	eybs
濬	eybu
𣿰	eybu
瀧	eybp
湞	eybc
𣽊	eybr
瀛	eynv
瀛	eync
注	eyg
澾	eygq
汶	eyk
济	eykl
済	eykl
潡	eydk
漷	eydl
澵	eydl
瀙	eydu
沚	eylm
沛	eylb
洂	eylc
瀢	eylc
涉	eylh
渉	eylh
澶	eywm
滷	eywi
澟	eywd
瀤	eywv
滖	eywv
瀣	eyem
澯	eyed
游	eysd
湤	eysd
淤	eysy
漩	eyso
漣	eyjj
灨	eyjc
汴	eyy
淑	eyfe
漓	eyub
滮	eyuh
汒	eyv
泫	eyvi
澭	eyvg
滀	eyvw
液	eyok
淬	eyoj
澞	eypk
滹	eypd
淲	eypu
澽	eypo
濾	eypp
瀘	eypt
濟	eyx
滳	eycb
滴	eycb
湾	eycn
洨	eyck
湙	eyck
滦	eycd
滚	eycv
滾	eycv
㴒	eyct
沾	eyr
滈	eyrb
涥	eyrn
渟	eyrn
灜	eyrn
𤅀	eyrn
𤅗	eyrn
淳	eyrd
滸	eyrj
涼	eyrf
湸	eyru
𣻼	eyru
瀼	eyrv
濠	eyro
湻	eyra
淖	eyaj
滻	eyhm
沆	eyhn
汸	eyhs
漨	eyhj
㳖	eyhv
濓	eyhc
瀕	eyhc
泣	eyt
湇	eytb
潼	eytg
㳯	eytj
漳	eytj
滰	eytu
滝	eytu
滝	eytv
淁	eytv
澻	eyto
澺	eytp
涪	eytr
湆	eyta
╕	ef
洸	efmu
消	efb
𣻸	efbb
漟	efbg
潎	efbk
澢	efbw
灙	efbf
溑	efbc
淌	efbr
洣	efd
潾	efdq
瀵	efdc
泮	efq
漛	efqe
潫	efqf
淃	efqu
淡	eff
𣶷	eff
瀅	effi
㶈	effi
濚	effd
濴	effe
澇	effs
濙	efff
瀠	efff
灐	effc
瀯	effr
沙	efh
渻	efhu
汕	eu
滍	eumi
湍	eumb
漄	eumg
瑬	eumgi
湠	eumf
溰	eumt
漰	eubb
涵	eune
澂	eugk
汹	euk
漴	eujf
灃	eujt
泏	euu
溦	euuk
𤀻	euud
涔	euon
漼	euog
鎏	euc
鍌	euc
𣺿	euhj
灧	eutu
潂	eutc
灩	eutt
汝	ev
濼	evid
泑	evis
泤	evio
淥	evne
湪	evno
𤁗	evfb
灣	evfn
濰	evfg
灤	evfd
𤀼	evfe
𤀽	evfr
灉	evug
漅	evvd
淄	evvw
洳	evr
氼	eo
汄	eo
㳋	eom
𣲚	eomm
淪	eomb
瀹	eomb
汵	eomn
汽	eomn
渝	eomn
洤	eomg
涂	eomd
澰	eomo
浜	eomc
洽	eomr
涻	eomr
澮	eoma
渰	eomt
瀸	eoim
泠	eoii
𣸮	eoii
汵	eoin
洑	eoik
湌	eoiv
淰	eoip
浛	eoir
滄	eoir
汭	eob
盜	eobt
汔	eon
滊	eond
淮	eog
潗	eogd
潐	eogf
瀿	eokf
滺	eokp
𣺈	eokr
㳜	eod
泭	eodi
漵	eodk
溆	eode
潊	eode
滫	eolb
潃	eolb
浟	eolk
滌	eold
海	eowy
洢	eosk
汻	eoj
涖	eoyt
𣳈	eou
溣	eoob
瀲	eook
㶑	eooo
沎	eop
沲	eopd
潝	eorm
潪	eora
渰	eort
漡	eoah
沴	eohh
潕	eotf
濮	eoto
沁	ep
汮	epmm
汋	epi
沟	epi
汮	epim
埿	epg
池	epd
柒	epd
𤃡	epdc
浺	epl
沏	epsh
渹	epyr
淗	epfd
沌	epu
洶	epuk
淘	epou
沘	epp
湝	eppa
泃	epr
泡	epru
洵	epa
𣇹	epa
泌	eph
淴	ephp
湉	ephr
沕	ephh
泄	ept
渫	eptd
淦	ec
汃	ec
滃	ecim
洕	ecb
涕	ecnh
滏	eckc
潧	ecwa
汾	ecsh
湓	ecst
浴	ecor
鍙	ecc
𤅺	eccc
沿	ecr
涗	ecru
涚	ecru
呇	er
╗	er
潞	ermr
涓	erb
溳	erbc
湒	ersj
濈	erji
浞	eryo
汜	eru
潠	eruc
洖	ervk
泯	ervp
惉	erp
湣	erpa
澠	erxu
𣲵	erc
澡	errd
湂	errs
潬	errj
澏	erru
浥	erau
浧	erhg
況	erhu
汨	ea
汩	ea
沓	ea
泹	eam
𣵀	eam
淂	eami
淏	eamk
涆	eamj
湜	eamo
湯	eamh
溉	eaiu
温	eabt
㵎	eanb
潤	eang
潣	eank
澖	eand
瀾	eanw
灁	eane
灛	eanj
灍	eano
濶	eanr
澗	eana
涅	eag
溡	eagi
漫	eawe
澷	eaws
溻	easm
𣸬	easr
濐	eaja
渂	eayk
澋	eayf
𣸭	eayt
滉	eafu
灦	eafc
灝	eafc
泿	eav
濕	eavf
渴	eapv
混	eapp
渇	eapp
淐	eaa
湦	eahm
湄	eahu
㵆	eahr
瀑	eate
╖	eh
璗	ehmgi
沂	ehml
泝	ehmy
澨	ehmo
浜	ehmc
洉	ehmr
硰	ehmr
溾	ehi
泛	ehio
𤅄	ehic
淛	ehbn
澳	ehbk
㶅	ehbd
洀	ehby
洎	ehbu
灚	ehbu
洫	ehbt
盪	ehbt
汎	ehni
渢	ehni
𣳽	ehnb
洬	ehnn
𣳼	ehnd
鯊	ehnwf
没	ehne
㵯	ehnf
𡌂	ehg
𤅕	ehgi
洗	ehgu
浩	ehgr
沃	ehk
𣾷	ehkb
添	ehkp
桬	ehd
𣓥	ehd
潲	ehdb
浰	ehdn
𣻗	ehdn
𣽿	ehdg
𣶸	ehdl
潘	ehdw
潻	ehde
𣵛	ehds
湫	ehdf
涹	ehdv
溗	ehdp
渪	ehlb
潷	ehlq
沠	ehlo
𤄙	ehlx
漗	ehwp
汳	ehe
汷	ehe
湰	ehem
涤	ehed
浲	ehej
洚	eheq
泈	ehey
洛	eher
瀊	ehet
泎	ehs
沪	ehs
淚	ehsk
激	ehsk
淭	ehsd
溵	ehse
滬	ehsu
汘	ehj
涶	ehjg
湩	ehjg
洙	ehjd
活	ehjr
挲	ehq
汼	ehq
泩	ehqm
涐	ehqi
湃	ehqj
泆	ehqo
㴲	ehyu
裟	ehyhv
燙	ehf
泘	ehfd
溾	ehui
溴	ehuk
濞	ehul
灒	ehuc
瀩	ehuc
濳	ehua
娑	ehv
泒	ehvo
汦	ehvp
洐	ehon
𣶹	ehon
㵟	ehok
瀓	ehok
澓	ehoe
㵌	ehou
漎	ehoo
漇	ehoo
汑	ehp
泜	ehpm
漑	ehpu
涽	ehpa
㳫	ehx
湼	ehxm
溲	ehxe
潟	ehxf
淣	ehxu
瀏	ehcn
溮	ehrb
溩	ehrf
𪄣	ehrf
泊	eha
淿	ehab
湟	ehag
瀄	ehal
湶	ehae
滜	ehaj
鳮	ehaf
澔	ehar
泖	ehhl
溜	ehhw
渒	ehhj
派	ehhv
泔	etm
𣶽	etmi
頮	etmbc
湈	etmd
𣺋	etmw
澕	etmj
湛	etmv
淇	etmc
渮	etmr
瀳	etif
𣷸	etio
漭	etit
湔	etbn
滢	etbg
潵	etbk
濛	etbo
淟	etbc
𤅎	etbc
𣿮	etnk
𣸱	etnu
溬	etgi
濧	etgi
𣿭	etgi
渼	etgk
漾	etge
溔	etgf
㵪	etgo
湵	etgo
濭	etgt
浂	etk
渕	etkn
渃	etkr
漌	etlm
滿	etlb
渶	etlk
漢	etlo
瀟	etlx
潢	etlc
浀	etw
渵	etw
澊	etwi
瀎	etwi
澫	etwb
濃	etwv
漕	etwa
澧	etwt
𣿯	etse
灆	etst
𣻻	etju
洋	etq
溠	etqm
淽	etym
淓	etys
𤂍	etyj
𣸆	etyp
𤅖	etyc
満	etub
溯	etub
滋	etvi
𤂋	etvd
濨	etvp
灘	etog
濩	etoe
瀁	etov
溚	etor
濸	etor
㵩	etpd
濍	etpp
溓	etxc
洪	etc
𣻺	etcg
澲	etcd
澌	etcl
湭	etcw
灇	etce
濝	etcf
𪃡	etcf
港	etcu
𣾴	etco
潽	etca
𣶼	etch
溢	etct
灌	etrg
濗	etab
漠	etak
灡	etaw
𣼵	ethn
𣿅	ethg
渞	ethu
洴	ett
汫	ett
溝	ettb
渆	ettn
灔	ettu
湴	ettc
𣾁	ettc
尸	s
𠃌	s
⺕	sm
刁	sm
匞	sm
羾	smm
頨	smmbc
屒	smmv
尋	smmri
镸	smi
𦐂	smi
屋	smig
翇	smikk
𦏵	smip
帚	smblb
翬	smbjj
𦑩	smbjj
覧	smbuu
監	smbt
屍	smnp
匡	smg
匤	smgi
翆	smknj
翜	smkoo
翍	smdhe
翀	sml
𠁨	sml
翼	smwtc
翄	smsme
羽	smsim
𡱰	smso
𦑊	smqmb
𦒄	smqjm
䎚	smqjp
𦐐	smyk
翴	smyjj
翠	smyoj
翯	smyrb
翞	smyrf
翌	smyt
翋	smyt
翣	smytv
灵	smf
彛	smfht
翪	smuce
長	smv
翭	smonk
翟	smog
翏	smohh
𦏸	smpd
翑	smpr
鍳	smc
翂	smcsh
司	smr
翨	smamo
毣	smhqu
翐	smhqo
習	smha
翵	smhaf
𦐒	smht
羿	smt
𤧬	simgi
覧	sibuu
監	sibt
鄩	sinl
镽	sikcf
螱	silmi
劚	siln
肆	silq
䦉	siwc
镼	sisuu
㞗	sije
褽	siyhv
熨	sif
忍	sip
慰	sip
鍳	sic
斸	sihml
镺	sihk
犚	sihq
镻	sihqo
髟	sihhh
匥	sit
彠	sitoe
刷	sbln
匷	sbug
屓	sbuc
屭	sbcc
朢	sbhg
孱	sndd
屙	snlr
戳	sgi
邼	sgnl
劻	sgks
剭	sgln
匵	sgwc
聽	sgjwp
鸐	sghaf
刄	sk
区	sk
尹	sk
尻	skn
欧	skno
匧	skoo
悘	skp
㞠	skcf
君	skr
帬	skrb
匲	skrr
殴	skhne
杘	sd
卩	sl
頣	slmbc
頤	slmbc
匪	slmy
屝	slmy
匱	slmc
匝	slb
屢	sllv
届	slw
屢	slwv
卩	sle
臤	sle
臣	slsl
臦	slsll
賾	slqmc
卧	sly
綤	slvif
臥	slo
臨	slorr
屇	sw
覽	swbuu
鹽	swbt
匣	swl
擥	swq
譼	swymr
鑒	swc
尿	se
瑿	semgi
𤩱	semgi
瓯	semvn
毉	semoo
醫	semcw
硻	semr
豎	semrt
腎	seb
臀	seb
瞖	sebu
贀	sebu
贀	sebuc
賢	sebuc
埾	seg
堅	seg
壂	seg
棸	sed
蜸	selmi
屬	sewi
黳	sewgf
翳	sesmm
掔	seq
竪	seyt
焣	sef
娶	sev
嫛	sev
婜	sev
緊	sevif
繄	sevif
匯	seog
聚	seooo
鋻	sec
犀	sehq
鷖	sehaf
巨	ss
臩	sskll
螶	sslii
燛	ssf
凹	ssu
兕	ssuu
局	ssr
耳	sj
聏	sjmbl
顳	sjmbc
耵	sjmn
𤩹	sjmg
璧	sjmgi
聇	sjmym
甓	sjmvn
礕	sjmr
聀	sji
聝	sjirm
臂	sjb
耼	sjbmm
孹	sjnd
耶	sjnl
聧	sjnok
聸	sjncr
壁	sjg
聃	sjgb
聐	sjgr
耾	sjki
屪	sjkf
聗	sjkoo
屠	sjka
檗	sjd
聎	sjlmo
聵	sjlmc
幦	sjlb
耽	sjlbu
刵	sjln
聘	sjlws
取	sje
郰	sjenl
聑	sjsj
聶	sjsjj
劈	sjsh
聢	sjjmo
聺	sjjbf
匭	sjjn
聴	sjjwp
䏁	sjjyj
聹	sjjpn
聜	sjjcm
擘	sjq
譬	sjymr
職	sjyia
耻	sjylm
聤	sjyrn
襞	sjyhv
耿	sjf
糪	sjfd
𦖠	sjff
耴	sju
聉	sjuu
嬖	sjv
聫	sjvik
聈	sjvis
繴	sjvif
聮	sjvif
聨	sjvit
聯	sjvit
𦖭	sjomn
𦕲	sjomr
聆	sjoii
耹	sjoin
聅	sjok
𣀳	sjok
聄	sjohh
恥	sjp
憵	sjp
聦	sjpkp
屄	sjc
鐾	sjc
聬	sjcim
聡	sjcip
聪	sjcrp
居	sjr
躄	sjryo
鼊	sjrxu
䎺	sjhbn
聥	sjhlb
聰	sjhwp
聒	sjhjr
毦	sjhqu
聣	sjhxu
鷿	sjhaf
聊	sjhhl
聛	sjhhj
联	sjtk
𦖿	sjtor
聠	sjtt
那	sqnl
馬	sqsf
𡲬	syyu
𢛶	syp
匟	syhn
屖	sytj
╪	sf
驪	sfmmp
駤	sfmig
驦	sfmbu
𩢤	sfmgi
𩤃	sfmlm
驑	sfmlw
駵	sfmls
驔	sfmwj
驃	sfmwf
騕	sfmwv
馯	sfmj
駓	sfmfm
駍	sfmfj
𩣪	sfmvm
駵	sfmx
騵	sfmhf
𩧃	sfmtb
驂	sfiih
䭾	sfik
駀	sfiku
𩦝	sfist
駥	sfij
駹	sfiuh
騃	sfiok
𩥝	sfiop
䮽	sfipf
騼	sfixp
駿	sfice
駘	sfir
駺	sfiav
馻	sfihu
駴	sfit
𩧉	sfitc
屑	sfb
駔	sfbm
駧	sfbmr
騧	sfbbr
騆	sfbgr
䮝	sfbjj
騱	sfbvk
䮐	sfbcr
駉	sfbr
𩥅	sfbhx
駳	sfnkm
騝	sfnkq
騤	sfnok
騛	sfnoo
驈	sfnhb
騥	sfnhd
馺	sfnhe
驍	sfggu
𩣱	sfgcg
馱	sfk
騎	sfkmr
駄	sfki
駁	sfkk
䮎	sfkkb
騻	sfkkk
𩣺	sfkjt
屎	sfd
㷉	sfdi
尉	sfdi
駃	sfdk
駷	sfdl
屡	sfdv
騋	sfdoo
駊	sfdhe
馽	sfl
騑	sflmy
駣	sflmo
駚	sflbk
駛	sflk
馴	sflll
駎	sflw
騁	sflws
驥	sflpc
驌	sflx
駰	sfwk
騍	sfwd
驛	sfwlj
騾	sfwvf
騦	sfwp
駟	sfwc
驆	sfwtj
龭	sfwtc
馭	sfe
騷	sfeii
駸	sfsme
龮	sfsmc
騽	sfsma
驏	sfsnd
驟	sfseo
駏	sfss
駶	sfssr
駬	sfsj
䯀	sfsjj
𩤅	sfsjr
驫	sfsff
駅	sfso
驅	sfsrr
駋	sfshr
𩥇	sfstv
騌	sfjmf
驞	sfjmc
驖	sfjig
馷	sfjb
馶	sfje
𩣑	sfjv
駝	sfjp
騞	sfqjr
騯	sfybs
䮾	sfybp
駐	sfyg
馼	sfyk
驐	sfydk
驙	sfywm
駭	sfyvo
驉	sfypm
驢	sfypt
駮	sfyck
驤	sfyrv
䮓	sfyaj
褧	sfyhv
騂	sfyt
騿	sfytj
駫	sffmu
驎	sffdq
驣	sffqf
䮗	sfumj
𩥉	sfumt
驨	sfuob
騣	sfuce
𩥪	sfuhj
騄	sfvne
騟	sfomn
駩	sfomg
駼	sfomd
驗	sfomo
騇	sfomr
駖	sfoii
騐	sfoip
騅	sfog
駇	sfok
駙	sfodi
駞	sfopd
駗	sfohh
馰	sfpi
騘	sfpkp
馳	sfpd
騶	sfpuu
騊	sfpou
駒	sfpr
駨	sfpa
駜	sfph
驓	sfcwa
䭻	sfcsh
駾	sfcru
駽	sfrb
騢	sfrse
驒	sfrrj
馹	sfa
駻	sfamj
騠	sfamo
𩥈	sfabt
騴	sfajv
騔	sfapv
騉	sfapp
䮖	sfaa
馸	sfhml
駈	sfhml
騩	sfhi
馾	sfhbu
颿	sfhni
駪	sfhgu
驕	sfhkb
騬	sfhdp
驄	sfhwp
駱	sfher
馿	sfhs
騸	sfhsm
騙	sfhsb
駯	sfhjd
騈	sfhjj
騀	sfhqi
騩	sfhui
馲	sfhp
騪	sfhxe
騜	sfhag
騡	sfhae
駠	sfhhl
騮	sfhhw
馵	sft
驊	sftmj
騏	sftmc
騚	sftbn
騹	sftlm
驠	sftlf
驧	sftjd
驜	sftcd
驩	sftrg
騲	sftaj
駢	sftt
㔾	su
己	su
已	su
屘	sund
邔	sunl
屆	sug
熙	suf
𤋮	suf
屈	suu
媐	suv
妀	suv
改	suok
忌	sup
𡲥	suhqm
兕	suhu
鶌	suhaf
异	sut
𢁉	sutc
屫	svmb
郾	svnl
𨃨	svryo
鶠	svhaf
尺	so
匬	somn
匳	somo
匼	somr
鄹	sonl
龨	sog
医	sok
尽	soy
𠥔	soog
咫	sorc
昼	soam
尼	sp
贒	spbuc
匜	spd
屁	spp
鵋	sphaf
匢	sphh
屉	spt
屟	sptd
匹	sc
層	scwa
殿	schne
鴄	schaf
叵	sr
𡰪	sr
╬	sr
頵	srmbc
甌	srmvn
覗	srbuu
盬	srbt
孠	srnd
郡	srnl
邵	srnl
歐	srno
劭	srks
尀	srdi
屌	srlb
刟	srln
剧	srln
剾	srln
卲	srsl
䛐	srymr
敺	srye
鸊	sryjf
裠	sryhv
辟	srytj
焄	srf
𤍥	srf
慝	srp
匰	srrj
巶	srru
區	srrr
𨛦	srrau
毆	srhne
聖	srhg
𠥹	srhrf
鶋	srha
鶋	srhaf
鷗	srhaf
鵘	srhaf
羣	srtq
群	srtq
翫	sammu
䣝	sanl
匽	sav
飁	sahni
鷵	sahaf
刀	sh
╫	sh
髨	shmmu
髵	shmbl
顟	shmbc
匠	shml
髬	shmfm
髡	shmu
髩	shmvs
刃	shi
戮	shi
刅	shii
鬖	shiih
髮	shikk
髥	shbmm
鬅	shbb
鬇	shbsd
𩬅	shby
匴	shbt
凥	shn
𩯕	shnmu
髳	shnih
鄝	shnl
髯	shgb
髻	shgr
鬌	shkmb
髪	shke
勠	shks
髤	shd
鬎	shdbn
瘌	shdln
鬆	shdci
髲	shdhe
䰎	shlmc
属	shlb
髧	shlbu
剹	shln
髴	shlln
鬟	shwlv
䰄	shwp
髿	shefh
匾	shsb
髶	shsj
髫	shshr
刕	shshh
鬃	shjmf
鬢	shjmc
鬒	shjbc
䰇	shjka
屛	shjj
鬡	shjpn
鬐	shjpa
鬍	shjrb
鬊	shqka
尾	shqu
髭	shymp
鬤	shyrv
髣	shyhs
鬔	shyhj
髾	shfb
鬈	shfqu
鬉	shuce
鬣	shvvv
鬂	shomc
鬠	shoma
屩	shob
雡	shog
髹	shod
屧	shod
履	shoe
屐	shoe
屨	shov
屣	shoo
髽	shoog
屜	shot
髢	shpd
髱	shpru
髰	shpt
刅	shc
鬀	shcnh
鬙	shcwa
召	shr
鬘	shawe
鳲	shaf
鬄	shaph
鬂	shhmc
髠	shhn
𩬎	shhg
鬁	shhdn
鬏	shhdf
髼	shhej
髺	shhjr
髦	shhqu
鷚	shhaf
鳭	shhaf
鬚	shhhc
鬋	shtbn
鬗	shtlb
髷	shtw
鬞	shtwv
鬑	shtxc
髸	shtc
鬕	shtak
匿	stkr
𡲢	stkr
羼	stqq
展	stv
匶	stox
屏	stt
［	zxbm
｛	zxbi
╴	zxbb
］	zxbn
︵	zxbg
︷	zxbk
﹏	zxbd
︸	zxbl
︽	zxbw
（	zxbe
︻	zxbs
｝	zxbj
【	zxbq
〈	zxby
）	zxbf
《	zxbu
》	zxbv
︹	zxbo
︺	zxbp
︾	zxbx
︴	zxbc
】	zxbr
︳	zxba
︶	zxbh
︼	zxbt
）	zxcm
』	zxci
＾	zxcb
｛	zxcn
﹂	zxcg
﹄	zxck
「	zxcd
（	zxcl
〞	zxcw
」	zxce
＇	zxcs
﹃	zxcj
〕	zxcq
′	zxcy
﹁	zxcf
＂	zxcu
〝	zxcv
｝	zxco
〔	zxcp
‵	zxcx
﹀	zxcc
｀	zxcr
〉	zxca
『	zxch
“	zxct
‥	zxam
？	zxai
，	zxab
﹐	zxan
；	zxag
︰	zxak
。	zxad
…	zxal
–	zxaw
．	zxae
﹕	zxas
！	zxaj
·	zxaq
—	zxay
‧	zxaf
﹗	zxau
｜	zxav
､	zxao
﹒	zxap
︱	zxax
、	zxac
﹔	zxar
　	zxaa
：	zxah
﹖	zxat
十	j
士	jm
𩓧	jmmbc
宗	jmmf
完	jmmu
崈	jmmu
宸	jmmv
賨	jmmc
室	jmig
𡨴	jmbn
寕	jmbn
宁	jmn
宝	jmgi
寚	jmgu
宇	jmd
寅	jmlc
寕	jmwn
翧	jmsmm
家	jmso
矗	jmjmm
定	jmyo
寳	jmfc
寇	jmue
宼	jmuv
寶	jmuc
惪	jmp
鑋	jmc
𡧳	jmcw
寡	jmch
宕	jmr
富	jmrw
宣	jmam
賓	jmhc
鵼	jmhaf
𡨭	jmtb
𡩅	jmtb
臷	jimig
甎	jimvn
酨	jimcw
博	jibi
鄟	jinl
寪	jikf
栽	jid
專	jidi
韯	jilmm
蛓	jilmi
剸	jiln
戴	jiwtc
翝	jismm
載	jijwj
裁	jiyhv
烖	jif
胾	jiobo
截	jiog
惠	jip
哉	jir
宬	jihs
鷒	jihaf
巿	jb
宜	jbm
直	jbmm
真	jbmc
蠹	jbmri
橐	jbmrd
献	jbik
賫	jbbuc
賷	jbbuc
孛	jbnd
寀	jbd
蟗	jblli
疐	jbwno
蟗	jbuui
索	jbvif
察	jbof
囊	jbrrv
櫜	jbhod
鶦	jbhaf
南	jbtj
宆	jn
麪	jnmls
麵	jnmwl
麫	jnmys
宖	jni
宐	jnim
麱	jnijb
宛	jniu
麰	jnihq
麮	jngi
字	jnd
麬	jndhe
剚	jnln
麶	jnjt
𡩣	jnqd
𪋿	jny
䴴	jnyr
麨	jnfh
寃	jnui
惌	jnup
麧	jnon
麴	jnpfd
鸋	jnhaf
𪄳	jnhaf
麯	jntw
𪍑	jntcw
䥅	jgc
丈	jk
耂	jk
耊	jkmig
孷	jkmnd
斄	jkmdo
釐	jkmwg
漦	jkme
剺	jkmsh
嫠	jkmv
寄	jkmr
犛	jkmhq
氂	jkmhu
宏	jki
宥	jkb
宄	jkn
孝	jknd
協	jkss
协	jksc
考	jkys
老	jkp
耇	jkpr
寮	jkcf
者	jka
㹈	jkhq
鶟	jkhaf
宋	jd
未	jd
𩓐	jdmbc
守	jdi
𣚺	jdisy
郣	jdnl
勃	jdks
教	jdok
𡨭	jdci
鵓	jdhaf
宨	jlmo
磛	jlmr
覱	jlbuu
塹	jlg
吏	jlk
槧	jld
事	jlln
寠	jllv
宙	jlw
寠	jlwv
疌	jlyo
宂	jlu
㟻	jlu
妻	jlv
慙	jlp
鏨	jlc
蹔	jlryo
暫	jla
覾	jwbuu
畞	jwno
寓	jwlb
寰	jwlv
車	jwj
實	jwjc
恵	jwp
支	je
頍	jembc
麪	jemls
麵	jemwl
麫	jemys
礊	jemr
麱	jeijb
麰	jeihq
麲	jebuu
墼	jeg
麮	jegi
攰	jeks
檕	jed
麬	jedhe
蟿	jelmi
翅	jesmm
攳	jesmi
寖	jese
轚	jejwj
撃	jeq
擊	jeq
麩	jeqo
麶	jeyub
麨	jefh
麷	jeujt
繫	jevif
麧	jeon
罊	jeoju
麭	jepru
宻	jecu
鳷	jehaf
麯	jetw
寥	jsmh
宭	jskr
宦	jsll
宧	jsll
膥	jsobo
卄	jj
廾	jj
転	jjmmi
輊	jjmig
轜	jjmbb
輭	jjmbk
輀	jjmbl
𨍥	jjmbv
軻	jjmnr
軖	jjmg
輛	jjmlb
軛	jjmsu
軒	jjmj
軯	jjmfj
軏	jjmu
輕	jjmvm
輻	jjmrw
轣	jjmhm
戟	jji
輚	jjii
𨍭	jjibi
軷	jjikk
輽	jjikw
輔	jjijb
軾	jjipm
轆	jjixp
𨌘	jjice
軩	jjir
轗	jjirp
𨋍	jjihu
輱	jjihr
朝	jjb
輣	jjbb
輖	jjbgr
寘	jjbc
轁	jjbhx
輞	jjbtv
軐	jjnj
軟	jjno
輓	jjnau
輮	jjnhd
轖	jjgow
輘	jjgce
轅	jjgrv
軑	jjk
輢	jjkmr
軚	jjki
軌	jjkn
轑	jjkcf
韓	jjdmq
輫	jjlmy
軮	jjlbk
軸	jjlw
寁	jjlo
輠	jjwd
轘	jjwlv
轠	jjwww
轊	jjwjm
轀	jjwot
軽	jjeg
輟	jjeee
軭	jjsmg
轇	jjsmh
轞	jjsmt
轞	jjsit
轏	jjsnd
輑	jjskr
輙	jjsje
輒	jjsju
䡱	jjsrr
軔	jjshi
軺	jjshr
輾	jjstv
輐	jjjmu
轉	jjjii
䡝	jjjnu
𨌆	jjjki
轟	jjjjj
轄	jjjqr
軲	jjjr
轒	jjjtc
輤	jjqmb
輳	jjqkk
轃	jjqkd
轊	jjqjm
𨌯	jjyib
轍	jjybk
軴	jjyg
軙	jjye
轋	jjyjj
輆	jjyvo
轤	jjypt
較	jjyck
𨍽	jjycv
𨎊	jjycv
輬	jjyrf
𨋢	jjyt
輄	jjfmu
輎	jjfb
轔	jjfdq
乹	jju
軋	jju
輲	jjumb
轢	jjvid
軪	jjvis
轈	jjvvd
輜	jjvvw
倝	jjo
輪	jjomb
輸	jjomn
輇	jjomg
𠏉	jjomd
幹	jjomj
龫	jjomj
軨	jjoii
軡	jjoin
軜	jjob
乾	jjon
亁	jjon
榦	jjod
軵	jjodi
螒	jjoli
翰	jjosm
𨌺	jjosm
斡	jjoyj
雗	jjoog
輹	jjoae
鶾	jjohf
軫	jjohh
輷	jjpyr
軘	jjpu
軥	jjpr
軳	jjpru
輍	jjcor
軎	jjr
輯	jjrsj
軹	jjrc
軦	jjrhu
輰	jjamh
輼	jjabt
輵	jjapv
輥	jjapp
斬	jjhml
輈	jjhby
軓	jjhni
軗	jjhne
軠	jjhg
轎	jjhkb
轓	jjhdw
輅	jjher
軶	jjhsn
輧	jjhjj
輴	jjhju
軞	jjhqu
軼	jjhqo
軤	jjhfd
軱	jjhvo
軝	jjhvp
軧	jjhpm
輗	jjhxu
轛	jjtg
轛	jjtgi
轙	jjtgi
輁	jjtc
輶	jjtcw
轐	jjtco
轥	jjtaw
轕	jjtav
軿	jjtt
车	jq
寈	jqmb
憲	jqmp
害	jqmr
実	jqk
轧	jqu
输	jqomn
轮	jqop
寵	jybp
寊	jybc
宔	jyg
实	jyk
寂	jyfe
宍	jyc
宰	jytj
灾	jf
宵	jfb
叜	jfe
七	ju
勀	juks
勊	juks
尅	judi
剜	juln
剋	juln
兢	jujru
寷	jujt
鵍	juhaf
鵷	juhaf
安	jv
寎	jvmb
頞	jvmbc
寐	jvmd
寱	jvmd
寢	jvme
寤	jvmr
寣	jvmr
郪	jvnl
案	jvd
悳	jvp
鴧	jvhaf
鶈	jvhaf
鴳	jvhaf
鞌	jvtj
顁	jombc
宿	joma
麥	joni
寯	jogs
𡧛	jodi
寑	jose
它	jp
耋	jpmig
寜	jpbn
寧	jpbn
甯	jpbq
寍	jpbt
𡩋	jpgb
寲	jpko
耈	jppr
耆	jpa
宓	jph
蜜	jphi
寗	jphb
耄	jphqu
密	jphu
䀄	jpht
穴	jc
空	jcm
竀	jcmmu
窒	jcmig
𥩔	jcmbm
顛	jcmbc
顮	jcmbc
穻	jcmd
穿	jcmvh
窉	jcmob
戭	jci
突	jcik
梥	jcid
䆲	jcile
窓	jcip
窢	jcirm
窚	jcihs
窩	jcbbr
窅	jcbu
窰	jcbou
穹	jcn
穵	jcn
穸	jcni
窿	jcnlm
歕	jcno
窞	jcnhx
窐	jcgg
竃	jcgwu
竇	jcgwc
窾	jcgfo
竈	jcgru
究	jckn
竂	jckcf
穼	jcd
窕	jclmo
帘	jclb
窶	jcllv
窠	jcwd
窏	jcemd
窪	jcegg
窡	jceee
翸	jcsmm
窘	jcskr
窷	jcsjl
窟	jcsuu
窴	jcjbc
窙	jcjkd
𥥖	jcjr
窺	jcqou
窫	jcqhk
竉	jcybp
窣	jcyoj
窔	jcyck
窨	jcyta
窲	jcfdj
窋	jcuu
𥧌	jcvmd
窈	jcvis
𥥆	jcvis
窼	jcvvd
窬	jcomn
窱	jcold
窄	jcos
窑	jcoju
容	jcor
窽	jcpko
窃	jcpsh
窀	jcpu
窇	jcpru
𥦬	jccwn
窤	jcapp
窆	jchio
窖	jchgr
穾	jchk
竊	jchdb
窸	jchdp
窗	jchwk
窻	jchwp
窄	jchs
竅	jchsk
窂	jchq
竁	jchuu
窊	jchvo
窳	jchoo
竄	jchxv
鷏	jcha
鷏	jchaf
䴐	jchaf
窵	jchaf
鴪	jchaf
窮	jchhn
窌	jchhl
窯	jctgf
穽	jctt
古	jr
額	jrmbc
瓳	jrmvn
胡	jrb
鶘	jrbhf
割	jrln
官	jrlr
辜	jrytj
𨐒	jrytj
故	jrok
愙	jrp
豁	jrcor
宫	jrr
嘏	jrrse
悹	jrrp
毄	jrhne
克	jrhu
宮	jrhr
鶷	jrha
鶷	jrhaf
鴣	jrhaf
𪃭	jrhaf
𪃾	jrhaf
彮	jrhhh
寔	jamo
覩	jabuu
都	janl
翥	jasmm
煑	jaf
煮	jaf
宴	jav
殾	jahne
賔	jahc
冗	jhn
宂	jhn
寗	jhgb
宪	jhgu
宎	jhk
㝯	jhkb
審	jhdw
㝢	jhlb
客	jher
牢	jhq
宒	jhqu
宷	jhfd
寙	jhoo
宅	jhp
寫	jhxf
愙	jhrp
卉	jt
卋	jt
寬	jtbi
寛	jtbu
賁	jtbc
鼖	jtge
桒	jtd
𡜦	jtv
𣇸	jtoa
塞	jtcg
寨	jtcd
搴	jtcq
寒	jtcy
騫	jtcf
寋	jtcu
褰	jtcv
蹇	jtco
賽	jtcc
謇	jtcr
寞	jtak
手	q
扌	q
扛	qm
抎	qmmi
扝	qmms
抏	qmmu
振	qmmv
攦	qmmp
捂	qmmr
挃	qmig
搢	qmia
青	qmb
擩	qmbb
攉	qmbg
靑	qmblm
擂	qmbw
擾	qmbe
摴	qmbs
靑	qmbyl
責	qmbuc
𢸍	qmbv
摃	qmbc
打	qmn
挒	qmnn
抲	qmnr
抂	qmg
捯	qmgn
捱	qmgg
挵	qmgt
扜	qmd
攊	qmdm
掗	qmlm
挭	qmlk
搮	qmwd
撢	qmwj
毒	qmwyi
纛	qmwyf
摽	qmwf
扼	qmsu
㧻	qmso
扞	qmj
撖	qmjk
拝	qmqj
抔	qmf
抷	qmfm
擟	qmfb
抨	qmfj
扤	qmu
撍	qmua
表	qmv
挳	qmvm
搙	qmvi
素	qmvif
抦	qmob
拪	qmcw
拓	qmr
搹	qmrb
揊	qmrw
揼	qmre
𢭃	qmrt
𢫦	qma
𢬎	qmam
擫	qmak
捓	qmhl
麦	qmhe
撅	qmto
找	qi
拡	qii
𢲲	qiil
撡	qiip
𢵄	qiia
摻	qiih
搏	qibi
㨩	qing
𢫕	qine
拔	qikk
势	qiks
撪	qikj
撝	qikf
扰	qiku
掺	qikh
攠	qidy
搪	qilr
护	qis
𢫨	qij
捕	qijb
捄	qije
掂	qiyr
捬	qioi
挨	qiok
拭	qipm
攈	qipd
攗	qipd
攟	qipw
摝	qixp
捘	qice
抬	qir
掝	qirm
撼	qirp
掋	qihm
摵	qihf
搣	qihf
抁	qihu
揻	qihv
拚	qit
𢬿	qit
摭	qitf
擴	qitc
抈	qb
抯	qbm
援	qbme
挏	qbmr
掤	qbb
搰	qbbb
授	qbbe
靜	qbbsd
靚	qbbuu
𢰸	qbbr
捊	qbnd
郬	qbnl
静	qbnsd
靘	qbnau
撚	qbkf
採	qbd
捋	qbdi
掙	qbsd
靛	qbjmo
揮	qbjj
拥	qbq
靗	qbfmu
𢫏	qbu
攫	qbue
挸	qbuu
挼	qbv
靝	qbond
摖	qbof
搖	qbou
摇	qbou
探	qbcd
攖	qbcv
搯	qbhx
鶄	qbhaf
𩇕	qbhhh
掆	qbtu
搦	qnmm
摾	qnii
捅	qnib
抒	qnin
拸	qnin
捔	qnbg
換	qnbk
𢶷	qnbq
扭	qng
挻	qnkm
挺	qnkg
揵	qnkq
搎	qndf
掹	qndt
撱	qnlb
𢵌	qnlo
擼	qnwa
拯	qnem
挅	qnsd
扟	qnj
搩	qnqd
扻	qno
揟	qnob
揆	qnok
撥	qnoe
撜	qnot
擔	qncr
攙	qnri
挽	qnau
揉	qnhd
扱	qnhe
扔	qnhs
掐	qnhx
扗	qg
抾	qgi
擮	qgig
搕	qgit
抩	qgb
撎	qgbt
擣	qgni
挂	qgg
掛	qggy
撓	qggu
持	qgdi
捇	qglc
𢳆	qgsk
𢴇	qgji
拮	qgr
擡	qgrg
擷	qgrc
挎	qkms
捺	qkmf
掎	qkmr
扏	qkn
挗	qkn
执	qkni
抛	qkns
𢯎	qkkb
摤	qkkk
寿	qkdi
抪	qklb
拵	qkld
掩	qklu
抜	qke
泰	qke
扐	qks
搚	qksb
拹	qkss
𢱕	qksj
摦	qkso
撦	qkja
捹	qkjt
奉	qkq
拻	qkf
拋	qkus
挾	qkoo
摕	qkpb
摋	qkce
撩	qkcf
𢱌	qkrd
春	qka
奏	qkhk
秦	qkhd
舂	qkhx
挟	qkt
耒	qd
耘	qdmmi
耰	qdmbe
頛	qdmbc
耨	qdmvi
耱	qdidr
耛	qdir
拺	qdb
揸	qdbm
耝	qdbm
耡	qdbms
耔	qdnd
抉	qdk
耞	qdksr
㨆	qdd
㩒	qddf
耚	qddhe
捒	qdl
揦	qdln
耬	qdllv
摗	qdlo
攋	qdlc
耦	qdwlb
揀	qdwf
耟	qdss
抹	qdj
耫	qdqmc
䆐	qdqdd
耪	qdybs
耥	qdfbr
耮	qdffs
耖	qdfh
耣	qdomb
耠	qdomr
耜	qdrlr
揸	qdam
耙	qdau
披	qdhe
耗	qdhqu
𦔒	qdtvi
耯	qdtoe
耤	qdta
耕	qdtt
耩	qdttb
排	qlmy
挑	qlmo
撌	qlmc
硩	qlmr
抰	qlbk
抌	qlbu
埑	qlg
蜇	qllmi
帮	qllb
拂	qlln
扸	qlll
摟	qllv
抽	qlw
抻	qlwl
捜	qlwe
摟	qlwv
拽	qlwp
捸	qle
誓	qlymr
裚	qlyhv
烲	qlf
焎	qlf
擻	qlvk
悊	qlp
揹	qlpb
㩋	qlx
銴	qlc
哲	qlr
踅	qlryo
晢	qla
幚	qlhab
揋	qwmv
摑	qwim
捚	qwg
㧢	qwk
摁	qwkp
捆	qwd
捰	qwd
押	qwl
摆	qwli
擉	qwli
攞	qwlg
擇	qwlj
擐	qwlv
擺	qwlp
攌	qwwv
摜	qwjc
拇	qwyi
摞	qwvf
搵	qwot
揌	qwp
撂	qwhr
𢳂	qwtj
扠	qei
搔	qeii
𢶣	qeem
搡	qeed
掇	qeee
挱	qefh
鋬	qec
韦	qs
撏	qsmi
掃	qsmb
握	qsmg
擢	qsmg
掁	qsmv
摺	qsma
摎	qsmh
㩜	qsit
拁	qskr
捃	qskr
㧜	qslb
挋	qsll
报	qsle
攬	qswu
摼	qseg
擓	qseg
摨	qseq
拒	qss
挶	qssr
挕	qsj
揶	qsjl
掫	qsje
攝	qsjj
据	qsjr
挪	qsql
搱	qsyj
摨	qsyq
掘	qsuu
択	qso
抳	qsp
擗	qsrj
摳	qsrr
揠	qsav
扨	qshi
𢲈	qshe
捤	qshu
招	qshr
搌	qstv
摒	qstt
丯	qj
丰	qj
揎	qjmm
捖	qjmu
掟	qjmo
擯	qjmc
砉	qjmr
摶	qjii
㨁	qjbm
擜	qjbk
挬	qjbd
揇	qjbj
擦	qjbf
𢱢	qjbf
攮	qjbv
搷	qjbc
邦	qjnl
鄻	qjnl
捥	qjnu
扙	qjk
拷	qjks
抺	qjd
捿	qjlv
捷	qjlo
捙	qjwj
技	qje
彗	qjsm
熭	qjsmf
慧	qjsmp
撠	qjji
㨴	qjjn
摲	qjjl
搟	qjjj
擀	qjjj
攇	qjqp
搳	qjqr
按	qjv
摍	qjoa
拕	qjp
擰	qjpn
搘	qjpa
控	qjcm
挖	qjcn
𢲷	qjck
搾	qjcs
攛	qjcv
搲	qjco
攨	qjco
𢱑	qjco
攧	qjcc
搈	qjcr
𢭪	qjru
捾	qjrr
邫	qjrau
抭	qjhu
挓	qjhp
揢	qjhr
攐	qjtv
攓	qjto
抙	qq
掅	qqmb
揍	qqkk
搸	qqkd
捧	qqkq
摏	qqkx
𢰦	qqka
挷	qqjl
掱	qqq
扥	qqu
扶	qqo
攆	qqoj
摫	qqou
攅	qqoc
揳	qqhk
扑	qy
掯	qymb
拤	qymy
摔	qyij
揥	qybb
撾	qybb
攡	qybg
撤	qybk
搒	qybs
攏	qybp
揁	qybc
攍	qynv
拄	qyg
撻	qygq
抆	qyk
撴	qydk
扯	qylm
捗	qylh
擅	qywm
揓	qysd
𢰧	qysd
㨗	qyso
抖	qyj
摙	qyjj
抃	qyy
擿	qyyb
掓	qyfe
摛	qyub
擁	qyvg
搐	qyvw
撁	qyvq
掖	qyok
捽	qyoj
摢	qypd
擄	qyps
據	qypo
攄	qypp
攎	qypt
擠	qyx
摘	qycb
挍	qyck
拈	qyr
搞	qyrb
㧸	qyrn
揨	qyrn
㨃	qyrd
攍	qyrw
掠	qyrf
𢴒	qyrf
攘	qyrv
掉	qyaj
摌	qyhm
抗	qyhn
摓	qyhj
挔	qyhv
搥	qyhr
拉	qyt
撞	qytg
摬	qytu
接	qytv
掊	qytr
揞	qyta
╒	qf
挄	qfmu
捎	qfb
摚	qfbg
撇	qfbk
擋	qfbw
撐	qfbq
撑	qfbq
攩	qfbf
撹	qfbu
撛	qfdq
挡	qfsm
拌	qfq
搼	qfqq
捲	qfqu
繛	qfyaj
掞	qff
㩞	qffd
撈	qffs
抄	qfh
挘	qfhs
㨘	qfhu
扎	qu
揣	qumb
鬹	qumrb
槼	qud
拙	quu
嫢	quv
紥	quvif
攜	quob
摧	quog
㩗	quos
𢹂	quos
摪	qvmi
擽	qvid
抝	qvis
拗	qvis
拟	qvio
掾	qvno
𢺳	qvfi
𢲩	qvfe
撧	qvfu
拶	qvvn
摷	qvvd
擸	qvvv
攭	qvoi
夫	qo
掄	qomb
揄	qomn
拴	qomg
捈	qomd
𢲡	qomq
撿	qomo
拾	qomr
捨	qomr
揜	qomt
攕	qoim
拎	qoii
扲	qoin
搇	qoiv
捻	qoip
搶	qoir
抐	qob
搉	qobg
規	qobuu
賛	qobuc
扢	qon
邞	qonl
推	qog
㩦	qogb
携	qogs
擕	qogs
撨	qogf
拊	qodi
扴	qoll
挴	qowy
輦	qojwj
扵	qoy
擒	qoyb
摿	qoya
挫	qoog
𢵄	qooa
拖	qopd
搿	qorq
揜	qort
替	qoa
摥	qoah
拰	qohg
鳺	qohaf
抮	qohh
撫	qotf
抋	qp
揯	qpmm
扚	qpi
抅	qpi
擬	qpko
扡	qpd
揈	qpyr
掬	qpfd
扽	qpu
搊	qpuu
掏	qpou
批	qpp
揩	qppa
拘	qpr
抱	qpru
指	qpa
㧾	qphp
抴	qpt
揲	qptd
憃	qxp
扒	qc
捦	qc
捴	qcip
鄼	qcnl
撳	qcno
挮	qcnh
勣	qcks
扮	qcsh
挩	qcru
捝	qcru
掰	qchq
扣	qr
╔	qr
捐	qrb
損	qrbc
𢬢	qrlb
剨	qrln
捌	qrsn
揖	qrsj
拐	qrsh
擑	qrji
捉	qryo
撰	qruc
抿	qrvp
抧	qrc
操	qrrd
撣	qrrj
挹	qrau
挰	qrhg
拀	qrhu
捛	qrhr
抇	qa
担	qam
𢸶	qame
捍	qamj
提	qamo
揚	qamh
揤	qail
摡	qaiu
揾	qabt
擝	qabt
捫	qan
撊	qanb
撋	qang
攔	qanw
擱	qanr
𢵧	qana
蠢	qalii
摱	qawe
搨	qasm
撮	qase
撔	qayf
㨪	qafu
把	qau
拫	qav
捑	qavk
惷	qap
揭	qapv
掍	qapp
掲	qapp
𪂹	qahaf
㩧	qate
╓	qh
折	qhml
拆	qhmy
捳	qhmu
抸	qhio
擙	qhbk
攥	qhbf
攪	qhbu
觢	qhnbg
投	qhne
㧥	qhgu
捁	qhgr
契	qhk
扷	qhk
𢶍	qhkm
撟	qhkb
掭	qhkp
栔	qhd
播	qhdw
揪	qhdf
捼	qhdv
拞	qhlm
蛪	qhlmi
掀	qhlo
抓	qhlo
捭	qhwj
摠	qhwp
扳	qhe
洯	qhe
拠	qhen
捀	qhej
挌	qher
拃	qhs
搧	qhsm
掮	qhsb
揙	qhsb
撽	qhsk
捩	qhsk
扦	qhj
捶	qhjm
揰	qhjg
挿	qhjw
揗	qhju
插	qhjx
揷	qhjx
括	qhjr
挈	qhq
抶	qhqo
齧	qhymu
搬	qhye
搋	qhyu
𢶠	qhfb
搝	qhuk
擤	qhul
撬	qhuu
擨	qhuo
攢	qhuc
㛃	qhv
絜	qhvif
抑	qhvl
扺	qhvp
摐	qhoo
𢲛	qhoo
撘	qhor
揝	qhoa
托	qhp
恝	qhp
抵	qhpm
捪	qhpa
捏	qhxm
揑	qhxm
搜	qhxe
掜	qhxu
攑	qhcq
摀	qhrf
拍	qha
𢴈	qham
𢯊	qhai
揘	qhag
擳	qhal
搗	qhau
捭	qhhj
挀	qhhv
捭	qhht
抍	qht
擶	qhtn
拑	qtm
撶	qtmj
揕	qtmv
掑	qtmc
揃	qtbn
撒	qtbk
攃	qtbf
𢶕	qtbf
捵	qtbc
𢷮	qtgi
撯	qtgu
擲	qtkl
掿	qtkr
撗	qtlc
描	qtw
撙	qtwi
擃	qtwv
搑	qtsj
𢶤	qtjp
擆	qtja
搓	qtqm
撯	qtqu
搠	qtub
攤	qtog
搽	qtod
擭	qtoe
攁	qtov
擹	qtoo
搭	qtor
擛	qtpd
搛	qtxc
拱	qtc
擈	qtcd
撕	qtcl
揂	qtcw
𢹸	qtce
撲	qtco
搤	qtct
擏	qtrk
措	qta
摸	qtak
擖	qtav
拼	qtt
搆	qttb
掽	qttc
辶	y
⺀	y
⺊	y
⻌	y
卜	y
上	ym
辷	ym
运	ymmi
顫	ymmbc
邐	ymmp
逜	ymmr
言	ymmr
歳	ymihf
歲	ymihh
肯	ymb
䢮	ymbw
覰	ymbuu
覷	ymbuu
贇	ymbuc
迾	ymnn
歔	ymno
迋	ymg
歭	ymgdi
𨘀	ymgc
迗	ymk
勯	ymks
迂	ymd
皻	ymdhe
皽	ymdhe
迊	ymlb
剷	ymln
遷	ymwu
歫	ymss
逐	ymso
歧	ymje
卡	ymy
歮	ymymm
还	ymf
邇	ymfb
歯	ymufd
齿	ymuo
齒	ymuoo
逕	ymvm
迓	ymvh
仧	ymo
𣁦	ymomg
忐	ymp
此	ymp
雌	ympog
迺	ymcw
逎	ymcw
𥈠	ymcu
逼	ymrw
逗	ymrt
歬	ymhby
歱	ymhjg
氈	ymhqu
衺	ymhv
鸇	ymhaf
遪	yiih
育	yib
塾	yig
迖	yik
逋	yijb
逑	yije
述	yijc
玆	yiyvi
熟	yif
玅	yifh
率	yioj
玈	yiohv
逡	yice
迨	yir
袬	yirv
充	yihu
斔	yihxo
螤	yihxo
弃	yit
棄	yitd
遮	yitf
迌	yb
甗	ybmv
甗	ybmvn
甋	ybmvn
遯	ybmo
睿	ybmcu
迵	ybmr
獻	ybik
𢅛	ybikp
過	ybbr
鄗	ybnl
欳	ybno
歊	ybno
歒	ybno
週	ybgr
𥜽	ybkb
槀	ybd
帝	yblb
運	ybjj
敲	ybye
㡣	ybysp
龍	ybysp
髚	ybyhn
旁	ybyhs
髝	ybffs
貞	ybuc
離	ybog
敵	ybok
遙	ybou
䢛	ybcr
啻	ybr
迥	ybr
髞	ybrrd
髜	ybaht
毃	ybhne
望	ybhg
稾	ybhd
邈	ybhu
鶙	ybhaf
鶮	ybhaf
盀	ybt
頏	ynmbc
歺	yni
通	ynib
迻	ynin
迯	yniy
袲	yniv
邂	ynbq
贏	ynbuc
邟	ynnl
遜	yndf
蠃	ynlmi
臝	ynwd
驘	ynsqf
迅	ynj
椉	ynqd
迩	ynf
逸	ynui
嬴	ynv
邆	ynot
逸	ynai
遹	ynhb
辸	ynhs
袤	ynhv
鸁	ynhaf
羸	yntq
主	yg
虧	ygmms
褻	ygiv
遶	yggu
勭	ygks
𦒍	ygsmm
遨	ygsk
逺	ygvv
逵	ygcg
迼	ygr
遠	ygrv
殶	yghne
氃	yghqu
達	ygtq
头	yk
文	yk
达	yk
遀	ykmb
斋	ykmbl
頝	ykmbc
斌	ykmpm
迏	yki
迶	ykb
斍	ykbuu
斈	yknd
郊	yknl
墪	ykg
効	ykks
效	ykks
対	ykdi
斉	yklm
蚉	yklmi
蠃	yklmi
斉	yklml
斎	yklml
螡	yklii
刘	ykln
齐	ykll
边	yks
𦐑	yksmm
迦	yksr
逩	ykjt
撉	ykq
齾	ykymu
紊	ykvif
效	ykok
憝	ykp
忞	ykp
遰	ykpb
鐜	ykc
遼	ykcf
吝	ykr
斕	ykanw
斖	ykhbm
逛	ykhg
斒	ykhsb
𣁄	ykhq
逖	ykhf
鳼	ykhaf
鷟	ykhaf
鴍	ykhaf
鵁	ykhaf
鵺	ykhaf
彣	ykhhh
𥂝	ykhhh
違	ydmq
过	ydi
親	ydbuu
郭	ydnl
歑	ydno
孰	ydkni
速	ydl
遫	ydlk
遬	ydlo
雜	ydog
敹	ydok
敦	ydok
𨔼	ydod
逨	ydoo
嚲	ydrrj
新	ydhml
鶉	ydhaf
虨	ydhhh
迚	yl
止	ylm
裵	ylmv
歨	ylmo
逃	ylmo
遺	ylmc
遣	ylmr
步	ylmh
歩	ylmh
市	ylb
亦	ylnc
亣	yll
剤	ylln
遱	yllv
迪	ylw
迧	ylwl
逮	yle
裵	ylyv
衷	ylhv
禀	ywmmf
衰	ywmv
畆	ywi
鹵	ywii
鹹	ywihr
𠧧	ywni
鄐	ywnl
畝	ywno
裹	ywgv
裏	ywgv
卤	ywk
裹	ywdv
遇	ywlb
逻	ywln
邏	ywlg
𨗴	ywlg
遝	ywle
褱	ywlv
還	ywlv
卣	yws
逥	ywyl
鹼	ywomo
迴	ywr
亶	ywrm
稟	ywrd
禀	ywrf
鹺	ywtqm
鹻	ywtxc
攴	ye
督	yebu
䱗	yenwf
壑	yeg
梷	yed
韰	yelsm
逫	yeee
裻	yeyhv
粲	yefd
逤	yefh
餐	yeoiv
惄	yep
錖	yec
迉	ys
与	ysm
瓬	ysmvn
覫	ysbuu
旔	ysnkq
邡	ysnl
堃	ysg
𡑔	ysg
旑	yskmr
旈	yskiv
遲	yseq
遤	ysqf
遟	ysyj
旞	ysyoo
𣃚	ysyhn
褭	ysfv
旊	ysomn
旚	ysomf
旃	ysoby
斿	ysond
旋	ysono
放	ysok
旖	ysokr
旇	ysode
斾	ysolb
斺	ysoll
旐	ysolo
旎	ysosp
旆	ysojb
於	ysoy
旜	ysoym
旒	ysoyu
旓	ysofb
旍	ysooi
族	ysook
旝	ysooa
施	ysopd
旌	ysohm
斻	ysohn
旂	ysohl
旛	ysohw
旄	ysohu
旅	ysohv
旟	ysohc
旗	ysotc
迡	ysp
避	ysrj
辺	ysh
迢	yshr
𣄃	ystmc
遅	ystq
斗	yj
辻	yj
贑	yjmbc
顇	yjmbc
𠁎	yjmy
㦸	yji
辨	yjilj
遖	yjbj
鄣	yjnl
辦	yjksj
辣	yjdl
蠭	yjlii
連	yjwj
辧	yjshj
辬	yjykj
𣁾	yjyjj
辯	yjyrj
辡	yjytj
辮	yjvfj
迱	yjp
邃	yjco
逭	yjrr
贛	yjhec
竷	yjhqe
瓣	yjhoj
鵫	yjhaf
彰	yjhhh
逰	yqod
逝	yqhl
卞	yy
這	yymr
逳	yyib
遆	yybb
遉	yybc
这	yyk
迹	yylc
邅	yywm
𨔁	yywn
逌	yyws
遊	yysd
☉	yyybm
☆	yyybi
▲	yyybb
◎	yyybn
□	yyybg
○	yyybk
▼	yyybd
●	yyybl
“	yyybw
◇	yyybe
§	yyybs
★	yyybj
♂	yyybq
˙	yyyby
◆	yyybf
‘	yyybu
”	yyybv
×	yyybo
※	yyybp
￥	yyybx
▽	yyybc
♀	yyybr
△	yyyba
■	yyybh
’	yyybt
〧	yyygm
〢	yyygi
Ⅲ	yyygb
〨	yyygn
Ⅸ	yyygg
〥	yyygk
Ⅵ	yyygd
〦	yyygl
〣	yyygj
Ⅷ	yyygf
Ⅳ	yyygc
Ⅱ	yyyga
〡	yyygh
∩	yyydm
≒	yyydi
±	yyydb
∠	yyydn
≧	yyydd
∪	yyydl
≠	yyyde
∴	yyyds
≡	yyydj
∮	yyydq
√	yyydf
⊿	yyydo
∫	yyydp
≦	yyydc
∵	yyydr
÷	yyyda
∞	yyydh
ˊ	yyyym
ㄣ	yyyyi
ㄜ	yyyyb
ˇ	yyyyn
ㄡ	yyyyg
ㄥ	yyyyk
ㄞ	yyyyd
ㄦ	yyyyl
ㄟ	yyyye
ㄤ	yyyyj
ㄠ	yyyyf
ˋ	yyyyo
ㄝ	yyyyc
ㄛ	yyyya
ㄢ	yyyyh
ㄑ	yyyxm
ㄍ	yyyxi
ㄆ	yyyxb
ㄒ	yyyxn
ㄋ	yyyxg
ㄏ	yyyxk
ㄈ	yyyxd
ㄐ	yyyxl
ㄨ	yyyxw
ㄉ	yyyxe
ㄗ	yyyxs
ㄎ	yyyxj
ㄕ	yyyxq
ㄚ	yyyxy
ㄊ	yyyxf
ㄙ	yyyxu
ㄧ	yyyxv
ㄓ	yyyxo
ㄔ	yyyxp
ㄩ	yyyxx
ㄇ	yyyxc
ㄖ	yyyxr
ㄅ	yyyxa
ㄌ	yyyxh
ㄘ	yyyxt
℅	yyycb
°	yyycg
￡	yyycd
℃	yyyce
℉	yyycf
￠	yyycc
⊕	yyyca
…	yyych
【	yyyam
」	yyyab
】	yyyan
《	yyyag
』	yyyad
↘	yyyaw
〈	yyyae
→	yyyas
↙	yyyay
〉	yyyaf
↓	yyyau
↗	yyyav
↖	yyyax
『	yyyac
「	yyyaa
》	yyyah
←	yyyat
⑶	yyyhm
⑨	yyyhi
②	yyyhb
⑷	yyyhn
⑦	yyyhg
⑴	yyyhk
④	yyyhd
⑵	yyyhl
⑤	yyyhe
⑼	yyyhs
⑩	yyyhj
⑺	yyyhq
⑥	yyyhf
𧜏	yyyhv
⑸	yyyho
⑹	yyyhp
③	yyyhc
⑻	yyyhr
①	yyyha
⑧	yyyhh
⑽	yyyht
遽	yypo
適	yycb
迠	yyr
逴	yyaj
迒	yyhn
遃	yyhh
遧	yytj
就	yfiku
逍	yfb
勍	yfks
迷	yfd
遴	yfdq
剠	yfln
叔	yfe
敊	yfye
䱷	yfok
鶁	yfhaf
辿	yu
齬	yummr
遄	yumb
齖	yumvh
虥	yuii
齝	yuir
齟	yubm
覤	yubuu
贙	yubuc
齮	yukmr
离	yukb
導	yudi
齼	yuddo
齥	yulwp
齫	yuwd
齵	yuwlb
叡	yue
𠮏	yue
𤫀	yuemi
齷	yusmg
齱	yusje
齠	yushr
𪙛	yustr
𪘲	yujbm
齻	yujbc
齜	yuymp
㪫	yuye
虤	yuypu
齩	yuyck
齴	yuyhh
競	yuytu
竸	yuytu
齓	yuu
𪘁	yuomr
齡	yuoii
齢	yuoii
齕	yuon
齘	yuoll
虪	yuolf
齔	yup
齺	yupuu
齣	yupr
齙	yupru
虝	yuphh
齛	yupt
蹵	yuryo
齪	yuryo
齞	yurc
齶	yurrs
齦	yuav
齗	yuhml
䶜	yuhgr
齲	yuhlb
齚	yuhs
齯	yuhxu
鷲	yuhaf
彪	yuhhh
甝	yutm
𪙊	yutxc
齸	yutct
齰	yuta
亡	yv
玄	yvi
畜	yviw
膂	yvb
肓	yvb
牽	yvbq
盲	yvbu
裔	yvbcr
邙	yvnl
逯	yvne
甕	yvgn
壅	yvgg
罋	yvgu
饔	yvgv
勷	yvks
杗	yvd
蝱	yvlii
𠨑	yvsl
妄	yvv
邋	yvvv
巡	yvvv
賌	yvoc
忘	yvp
氓	yvrvp
朚	yvab
衁	yvhbt
雍	yvhg
巟	yvhlu
瓤	yvhvo
亥	yvho
込	yo
	yo
龰	yo
頦	yombc
逾	yomn
途	yomd
賌	yobuc
迄	yon
夜	yonk
郂	yonl
欬	yono
進	yog
劾	yoks
勮	yoks
褒	yodv
韲	yolmm
劇	yoln
刻	yoln
迮	yos
迕	yoj
嬜	yov
卒	yooj
迤	yopd
亱	yoam
毅	yohne
𣫛	yohne
虍	yp
龒	ypmm
些	ypmm
龒	ypmmf
祡	ypmmf
龑	ypmk
豦	ypmso
礱	ypmr
砦	ypmr
鬳	ypmrb
虘	ypbm
眥	ypbu
貲	ypbuc
㱔	ypni
觜	ypnbg
鮆	ypnwf
㘹	ypg
壟	ypg
勴	ypks
迆	ypd
㰍	ypd
柴	ypd
蠪	yplmi
膚	ypwb
盧	ypwbt
虜	ypwks
歶	ypwlb
慮	ypwp
虐	ypsm
聾	ypsj
驡	ypsqf
讋	ypym
讋	ypymr
訾	ypymr
龘	ypybp
虔	ypyk
襲	ypyhv
迍	ypu
袌	ypuv
姕	ypv
紫	ypvif
飺	ypoiv
胔	ypobo
雐	ypog
虙	ypph
鈭	ypc
呰	ypr
虞	yprvk
啙	yprr
迿	ypa
虗	yphml
處	yphen
虖	yphfd
虎	yphu
鸗	yphaf
鷾	yphaf
迣	ypt
虛	yptm
虡	yptmc
虚	yptc
龔	yptc
齊	yx
齎	yxbuc
齍	yxbt
韲	yxlmm
劑	yxln
齏	yxlsm
𪗋	yxyhv
齋	yxf
齌	yxf
六	yc
戯	yci
戱	yci
兖	yciu
衮	yciv
衮	ycihv
商	ycbr
啇	ycbr
孪	ycnd
弯	ycnd
𨜓	ycnl
递	ycnh
奕	yck
交	yck
栾	ycd
蛮	yclmi
帟	yclb
变	yce
挛	ycq
峦	ycu
脔	ycobo
恋	ycp
戅	ycp
戇	ycp
𢥫	ycp
銮	ycc
兗	ycrhu
袞	ycrhv
顰	ychwj
変	yche
鶐	ycha
鶐	ychaf
鵉	ychaf
弈	yct
占	yr
訌	yrm
誫	yrmmv
語	yrmmr
𧧝	yrmmh
誈	yrmig
譳	yrmbb
謣	yrmbs
頕	yrmbc
訂	yrmn
訶	yrmnr
謌	yrmnr
訏	yrmd
讈	yrmdm
諲	yrmwg
譚	yrmwj
謤	yrmwf
𧦠	yrmsu
諑	yrmso
訐	yrmj
譀	yrmjk
詽	yrmjj
証	yrmym
評	yrmfj
譖	yrmua
誙	yrmvm
瓿	yrmvn
訝	yrmvh
誣	yrmoo
𧪽	yrmca
讍	yrmrg
諨	yrmrw
謌	yrmrr
讈	yrmhm
𧨊	yrmhs
謜	yrmhf
战	yri
諓	yrii
謲	yriih
詠	yrine
詙	yrikk
譌	yrikf
訧	yriku
詶	yrill
誧	yrijb
訹	yrijc
誒	yriok
諮	yrior
試	yripm
誜	yrice
詒	yrir
誏	yriav
誠	yrihs
諴	yrihr
誡	yrit
謶	yritf
譧	yritc
詛	yrbm
諼	yrbme
詷	yrbmr
膏	yrbb
䛵	yrbbe
諣	yrbbr
亭	yrbn
調	yrbgr
槀	yrbd
稾	yrbd
驘	yrbsn
諍	yrbsd
諢	yrbjj
毫	yrbu
亮	yrbu
覘	yrbuu
誢	yrbuu
謑	yrbvk
豪	yrbo
謠	yrbou
亳	yrbp
𧨾	yrbcd
詗	yrbr
高	yrbr
譌	yrbhf
謟	yrbhx
誷	yrbtv
詭	yrnmu
誦	yrnib
誃	yrnin
詺	yrnir
讂	yrnbe
亨	yrnn
誕	yrnkm
𧩙	yrnkm
誔	yrnkg
享	yrnd
𧪾	yrndf
訠	yrnl
部	yrnl
讔	yrnlp
訊	yrnj
謋	yrnqd
誸	yrnyi
烹	yrnf
諝	yrnob
𧬋	yrnoe
證	yrnot
譫	yrncr
讒	yrnri
譎	yrnhb
諂	yrnhx
譸	yrgni
詿	yrgg
譊	yrggu
詩	yrgdi
讀	yrgwc
謸	yrgsk
誌	yrgp
讟	yrgcr
詰	yrgr
譆	yrgrr
奌	yrk
誇	yrkms
詴	yrkb
訅	yrkn
訙	yrkni
誵	yrkkb
勏	yrks
譇	yrkja
詼	yrkf
誑	yrkhg
諱	yrdmq
討	yrdi
訣	yrdk
諃	yrdd
誎	yrdl
諌	yrdw
諫	yrdwf
誺	yrdoo
詖	yrdhe
誹	yrlmy
誂	yrlmo
訦	yrlbu
訲	yrlbu
剖	yrln
訓	yrlll
謱	yrllv
謱	yrlwv
畗	yrw
謂	yrwb
課	yrwd
譯	yrwlj
譞	yrwlv
讄	yrwww
謴	yrwjc
諰	yrwp
訵	yrwc
謖	yrwce
㕡	yre
訍	yrei
諁	yreee
誻	yrea
詡	yrsmm
誆	yrsmg
誛	yrsme
詞	yrsmr
謵	yrsma
謬	yrsmh
譅	yrsim
認	yrsip
遐	yrse
詎	yrss
誀	yrsj
諏	yrsje
讘	yrsjj
謘	yrsyj
記	yrsu
誳	yrsuu
誋	yrsup
䛏	yrsp
謳	yrsrr
訒	yrshi
詔	yrshr
計	yrj
諠	yrjmm
詝	yrjmn
誴	yrjmf
𧨎	yrjmu
諚	yrjmo
譓	yrjip
誼	yrjbm
誖	yrjbd
諵	yrjbj
謓	yrjbc
䛷	yrjnu
誟	yrjkd
諸	yrjka
誱	yrjlo
謿	yrjjb
詑	yrjp
𧭈	yrjpn
詁	yrjr
讅	yrjhw
詫	yrjhp
請	yrqmb
諘	yrqmv
謮	yrqmc
誄	yrqd
譿	yrqjp
讃	yrqoc
訃	yry
訿	yrymp
誩	yrymr
識	yryia
諦	yrybb
讞	yrybk
謗	yrybs
註	yryg
譈	yrydk
訨	yrylm
譴	yrylr
譠	yrywm
敁	yrye
㪗	yrye
𧩹	yrysd
謰	yryjj
遲	yryq
讁	yryyb
謎	yryfd
諔	yryfe
謧	yryub
詃	yryvi
該	yryvo
誶	yryoj
謯	yryp
謯	yrypm
謔	yrypm
譃	yrypm
謼	yrypd
諕	yrypu
謪	yryc
謫	yrycb
詨	yryck
詀	yryr
謞	yryrb
諪	yryrn
諄	yryrd
諒	yryrf
讓	yryrv
譹	yryro
訪	yryhs
諺	yryhh
譢	yryto
譩	yrytp
諳	yryta
京	yrf
点	yrf
誚	yrfb
譡	yrfbw
讜	yrfbf
詸	yrfd
詊	yrfq
𧬸	yrfqr
談	yrff
訬	yrfh
乩	yru
訕	yru
諯	yrumb
訩	yruk
詘	yruu
讗	yruob
選	yruc
譏	yrvii
詏	yrvis
訆	yrvl
詉	yrve
詤	yrvou
論	yromb
讑	yromb
諭	yromn
詮	yromg
譣	yromo
詥	yromr
譮	yroma
讖	yroim
詅	yroii
訡	yroin
諗	yroip
誝	yroir
謒	yroir
訥	yrob
訖	yron
誰	yrog
謢	yroge
譙	yrogf
敨	yrok
詂	yrodi
誨	yrowy
詐	yros
許	yroj
𧪄	yroyr
訛	yrop
診	yrohh
譕	yrotf
訫	yrp
訋	yrpi
𧥺	yrpim
譺	yrpko
訑	yrpd
諊	yrpfd
訰	yrpu
詾	yrpuk
謅	yrpuu
諧	yrppa
訽	yrpr
詣	yrpa
詢	yrpa
𧩓	yrphp
謐	yrpht
詍	yrpt
諜	yrptd
諡	yrcmt
訟	yrci
訜	yrcsh
說	yrcru
説	yrcru
遌	yrrs
諿	yrrsj
遻	yrru
𨕬	yrru
譔	yrruc
襄	yrrv
誤	yrrvk
譝	yrrxu
讝	yrrrk
譟	yrrrd
諤	yrrrs
譂	yrrrj
詋	yrrhu
亯	yra
詚	yra
諟	yramo
諹	yramh
譋	yranb
讕	yranw
讇	yranx
𧬘	yrana
謾	yrawe
裛	yrav
詪	yrav
謁	yrapv
誯	yraa
訢	yrhml
訴	yrhmy
詬	yrhmr
謉	yrhi
詯	yrhbu
諷	yrhni
設	yrhne
逞	yrhg
譭	yrhge
詵	yrhgu
誥	yrhgr
訞	yrhk
譑	yrhkb
訸	yrhd
謻	yrhdn
譒	yrhdw
誘	yrhds
諉	yrhdv
諀	yrhwj
謥	yrhwp
𧧽	yrhej
詻	yrher
詐	yrhs
謆	yrhsm
諞	yrhsb
譤	yrhsk
諈	yrhjm
諥	yrhjg
誅	yrhjd
話	yrhjr
誐	yrhqi
詄	yrhqo
謕	yrhyu
讚	yrhuc
哀	yrhv
譗	yrhor
託	yrhp
詆	yrhpm
諙	yrhpa
謏	yrhxe
誽	yrhxu
諛	yrhxo
諻	yrhag
謝	yrhhi
諀	yrhhj
㣌	yrhhh
詌	yrtm
謀	yrtmd
譁	yrtmj
諶	yrtmv
諆	yrtmc
譾	yrtbm
謭	yrtbh
議	yrtgi
譵	yrtgi
讛	yrtgi
𧬆	yrtgr
諾	yrtkr
謹	yrtlm
諽	yrtlj
讌	yrtlf
譐	yrtwi
譨	yrtwv
𧬹	yrtwt
詳	yrtq
𧬺	yrtyb
謊	yrtyu
護	yrtoe
䜓	yrtpd
謙	yrtxc
譜	yrtca
謚	yrtct
讙	yrtrg
䜘	yrtrk
諎	yrta
𧫴	yrtam
謨	yrtak
譪	yrtav
誁	yrtt
講	yrttb
諩	yrttc
𨑨	ya
𩐳	yambc
遈	yamo
逿	yamh
戠	yai
𩑈	yaitc
歆	yano
桌	yad
𢂚	yalb
遢	yasm
韶	yashr
卓	yaj
韼	yayhj
亰	yaf
退	yav
暹	yaog
恴	yap
韵	yapmm
韵	yapim
遏	yapv
𩐝	yapr
逷	yaph
韻	yarbc
𩐿	yaayf
韸	yahej
韹	yahag
鶕	yahaf
韺	yatlk
頀	yatoe
𩐠	yatc
广	yh
顪	yhmbc
顏	yhmbc
頻	yhmbc
顔	yhmbc
近	yhml
遾	yhmo
逅	yhmr
褢	yhiv
亹	yhbm
逈	yhbr
亢	yhn
𨑳	yhg
选	yhgu
𨘻	yhgv
造	yhgr
𨘥	yhgr
透	yhds
褎	yhdv
襃	yhdv
逶	yhdv
劌	yhln
邍	yhwe
褏	yhwv
返	yhe
邍	yhee
逢	yhej
逄	yheq
迮	yhs
方	yhs
翽	yhsmm
遍	yhsb
邀	yhsk
𨘋	yhsd
迁	yhj
逬	yhjj
遁	yhju
适	yhjr
逓	yhqb
袠	yhqv
迭	yhqo
𨒂	yhym
遞	yhyu
邊	yhus
邉	yhur
衣	yhv
迎	yhvl
袠	yhov
遚	yhxe
裒	yhxv
亷	yhxc
追	yhrr
迫	yha
遑	yhag
鳪	yhaf
遛	yhhw
產	yhhqm
産	yhhqm
裦	yhhv
彥	yhhhh
彦	yhhhh
立	yt
𨑬	yt
顱	ytmbc
竰	ytmwg
竵	ytmrb
竡	ytma
戲	yti
䇊	ytii
竢	ytiok
竣	ytice
竫	ytbsd
覻	ytbuu
𨚪	ytnl
竳	ytnot
竒	ytnr
𥪯	ytggu
䢭	ytgo
送	ytk
竑	ytki
逽	ytkr
𨔽	ytkr
亲	ytd
竦	ytdl
𨗨	ytdq
遵	ytwi
邁	ytwb
童	ytwg
竜	ytwu
遭	ytwa
翊	ytsmm
竮	ytstt
竍	ytj
辛	ytj
竚	ytjmn
竱	ytjii
竩	ytjbm
竤	ytjki
攱	ytje
靖	ytqmb
站	ytyr
𥪜	ytyrn
䇏	ytyrd
竝	ytyt
𥪮	ytytj
逆	ytu
端	ytumb
遡	ytub
妾	ytv
竛	ytoii
䇄	yton
遳	ytog
遂	ytpo
竘	ytpr
遒	ytcw
竲	ytcwa
竕	ytcsh
咅	ytr
暜	yta
逪	yta
音	yta
章	ytaj
意	ytap
竭	ytapv
竟	ytahu
竌	ythn
颯	ythni
竐	ythne
𥪕	ythdl
竬	ythlb
竏	ythj
竓	ythqu
道	ythu
竧	ythxh
亷	ythc
鴗	ythaf
鸕	ythaf
竔	ytht
迸	ytt
遘	yttb
火	f
⺌	f
⺍	f
灬	f
灴	fm
厳	fmmjk
焐	fmmr
燯	fmbi
燸	fmbb
煗	fmbk
爧	fmbo
煩	fmbc
灯	fmn
炣	fmnr
爏	fmdm
煙	fmwg
燂	fmwj
熛	fmwf
炍	fme
烼	fmso
㶥	fmj
炡	fmym
炋	fmf
烣	fmf
光	fmu
熸	fmua
烴	fmvm
炳	fmob
兴	fmc
炻	fmr
煏	fmrw
烜	fmam
㷧	fmhf
爄	fmtb
𤎜	fiib
煿	fibi
炦	fikk
炢	fikc
蠽	filii
𤎖	file
焿	filo
煻	filr
炉	fis
烳	fijb
烒	fipm
爊	fipf
熝	fixp
焌	fice
炲	fir
烺	fiav
煘	fihr
熫	fitf
燫	fitc
爌	fitc
肖	fb
煖	fbme
烔	fbmr
焩	fbb
燰	fbbe
覚	fbbuu
煱	fbbr
学	fbnd
烰	fbnd
坣	fbg
労	fbks
燃	fbkf
栄	fbd
𤊕	fbd
削	fbln
爝	fbwi
煇	fbjj
烿	fbyh
爠	fbug
䙺	fbuu
敝	fbok
敞	fbok
熎	fbou
烱	fbcr
炯	fbcr
炯	fbr
尙	fbr
尚	fbr
瓽	fbrmn
牚	fbrmh
賞	fbrbc
堂	fbrg
棠	fbrd
常	fbrlb
當	fbrw
黨	fbrwf
掌	fbrq
裳	fbryv
嘗	fbrpa
党	fbrhu
甞	fbrtm
熐	fbac
𤆤	fbhn
熖	fbhx
鶺	fbhaf
焵	fbtu
㶴	fnin
煥	fnbk
炄	fng
烻	fnkm
烶	fnkg
煡	fnkq
邩	fnl
揱	fnq
𤌴	fnqd
𦂗	fnvif
炊	fno
燈	fnot
燏	fnhb
煣	fnhd
𤆣	fnhe
焰	fnhx
尘	fg
灶	fg
熆	fgit
燽	fgni
烓	fgg
燒	fggu
焃	fglc
𤊥	fgce
爀	fgcc
熺	fgrr
𤐵	fgrr
尖	fk
類	fkmbc
斃	fkmnp
獘	fkik
烠	fkb
瞥	fkbu
彆	fkn
鱉	fknwf
煃	fkgg
烯	fkkb
𤉶	fkkb
蟞	fklmi
幣	fklb
熁	fksb
燲	fksc
撆	fkq
尜	fkf
嫳	fkv
憋	fkp
鐅	fkc
燎	fkcf
蹩	fkryo
鼈	fkrxu
鄨	fkrau
暼	fka
氅	fkhqu
鷩	fkhaf
弊	fkt
米	fd
𣏦	fd
炑	fd
䉺	fdm
糯	fdmbb
頪	fdmbc
𥺼	fdmlm
粳	fdmlk
糆	fdmwl
煒	fdmq
糣	fdmua
粞	fdmcw
粨	fdma
糲	fdmtb
糝	fdiih
糐	fdibi
粧	fdig
𥺁	fdigi
糠	fdile
糖	fdilr
𥺦	fdiyr
䊌	fdipp
麊	fdixp
粮	fdiav
粗	fdbm
粡	fdbmr
粰	fdbnd
粯	fdbuu
𥺂	fdbcr
粣	fdbt
糑	fdnmm
糨	fdnii
粦	fdniq
粈	fdng
籽	fdnd
粌	fdnl
籸	fdnj
糈	fdnob
糅	fdnhd
𥺃	fdgp
糦	fdgrr
炔	fdk
类	fdk
粋	fdknj
籿	fddi
粖	fddj
𥻗	fddam
爩	fddh
粙	fdlw
畨	fdw
粴	fdwg
粿	fdwd
糬	fdwla
𥹉	fdwe
糰	fdwji
煉	fdwf
糞	fdwtc
糔	fdeii
粻	fdsmv
糮	fdsit
粔	fdss
粎	fdso
籾	fdshi
籵	fdj
粽	fdjmf
粀	fdjk
糊	fdjrb
精	fdqmb
烞	fdy
料	fdyj
粹	fdyoj
粘	fdyr
粇	fdyhn
糙	fdyhr
粒	fdyt
糡	fdytu
糛	fdfbg
粆	fdfh
籼	fdu
糉	fduce
糭	fduce
娄	fdv
籹	fdv
𥽋	fdomo
籺	fdon
糇	fdonk
𥼚	fdogf
敉	fdok
粚	fdopd
粷	fdpfd
粃	fdpp
粅	fdphh
粉	fdcsh
糧	fdamg
糃	fdamh
粑	fdau
籶	fdhn
粺	fdhwj
粄	fdhe
糄	fdhsb
粁	fdhj
粍	fdhqu
糗	fdhuk
糌	fdhoa
籷	fdhp
粕	fdha
粓	fdtm
糂	fdtmv
粸	fdtmc
糋	fdtbn
糕	fdtgf
䊔	fdtlk
粬	fdtw
糟	fdtwa
糍	fdtvi
糚	fdtvg
粠	fdtc
糢	fdtak
糷	fdtaw
糒	fdthb
烛	flmi
烑	flmo
燼	flmt
爞	flii
炴	flbk
灲	fln
炥	flln
熡	fllv
熡	flwv
熽	flx
畄	fw
畑	fw
顲	fwmbc
煨	fwmv
煟	fwb
爅	fwgg
烟	fwk
煾	fwkp
煾	fwkp
巣	fwd
炠	fwl
燭	fwli
劏	fwln
𤓓	fwlg
燡	fwlj
単	fwj
𤎽	fwjc
熅	fwot
熚	fwtj
𤒹	fwtj
熼	fwtc
当	fsm
燖	fsmi
㷌	fsmb
燿	fsmg
熠	fsma
熮	fsmh
熤	fsmt
爁	fsit
𤉙	fskr
㮡	fsd
爦	fswu
爥	fsei
熞	fseg
炬	fss
焗	fssr
𤉸	fsjr
爥	fsyi
煀	fsuu
熰	fsrr
灱	fsh
炤	fshr
𤋊	fstt
煊	fjmm
烷	fjmu
㶿	fjbd
煵	fjbj
焥	fjnu
烤	fjks
爎	fjkf
𤉖	fjwj
𤇼	fjv
炼	fjvd
炨	fjp
焢	fjcm
焪	fjcn
熔	fjcr
煳	fjrb
熍	fjrr
烢	fjhp
燌	fjtc
半	fq
頖	fqmbc
豢	fqmso
甐	fqmvn
飬	fqmav
飬	fqiav
眷	fqbu
弮	fqn
觠	fqnbg
鄰	fqnl
鮝	fqnwf
劵	fqks
桊	fqd
韏	fqdmq
帣	fqlb
判	fqln
𣳾	fqe
翷	fqsmm
駦	fqsqf
卷	fqsu
巻	fqsu
券	fqsh
拳	fqq
齤	fqymu
亃	fqu
絭	fqvif
粼	fqvv
𥻘	fqvvv
叛	fqhe
牶	fqhq
焴	fyib
熾	fyia
爖	fybp
𤋺	fybc
熥	fynb
炷	fyg
燵	fygq
炆	fyk
燉	fydk
燣	fywd
燦	fyed
𤍣	fysg
炓	fyj
炫	fyvi
烗	fyvo
焲	fyok
焠	fyoj
爈	fypp
爐	fypt
熵	fycb
烄	fyck
炶	fyr
熇	fyrb
焞	fyrd
燺	fyrd
煷	fyru
爙	fyrv
𤐶	fyro
焯	fyaj
煺	fyav
炕	fyhn
熢	fyhj
燑	fytg
𤍤	fytj
燧	fyto
燱	fytp
焙	fytr
炎	ff
炏	ff
顃	ffmb
纇	ffmbc
𤈛	ffmu
焇	ffb
瑩	ffbmi
甇	ffbmn
醟	ffbmw
禜	ffbmf
膋	ffbb
龦	ffbb
覮	ffbbu
𡦃	ffbnd
煢	ffbnj
塋	ffbg
𤎌	ffbg
勞	ffbks
榮	ffbd
檾	ffbdd
螢	ffbli
滎	ffbe
檾	ffbjc
褮	ffbyv
謍	ffbyr
爣	ffbf
熒	ffbf
嵤	ffbu
覢	ffbuu
嫈	ffbv
縈	ffbvf
罃	ffbou
鎣	ffbc
營	ffbrr
𤯵	ffbhm
焭	ffbhn
犖	ffbhq
鶯	ffbhf
郯	ffnl
欻	ffno
歘	ffno
烾	ffg
燐	ffdq
剡	ffln
燮	ffe
𡠺	ffjv
炏	ffqj
炐	ffqj
敥	ffye
虩	ffypu
煔	ffyr
尛	fff
焱	fff
爕	fff
𤑚	fffi
𤍢	fffg
燊	fffd
𤒇	fffd
爃	fffd
𤏪	fffs
燚	ffff
熦	ffog
炒	ffh
飊	ffhni
夑	ffhe
鶑	ffhaf
灿	fu
煓	fumb
𤍈	fumt
兤	fuitc
輝	fubjj
勌	fuks
耀	fusmg
𦒉	fusma
炪	fuu
熣	fuog
𣆤	fua
𣆥	fua
熴	fuap
㷨	fuhj
𧹍	fuhuc
𤾗	fuhag
㒯	futmj
爍	fvid
㶭	fvis
爉	fvvv
数	fvok
尐	fo
熻	fomm
㷍	fomb
爚	fomb
烇	fomg
烚	fomr
燴	foma
炩	foii
焾	foip
熗	foir
焓	foir
𤌍	fobg
熂	fond
焳	fog
雀	fog
燋	fogf
炇	fok
烌	fod
炌	foll
烸	fowy
炸	fos
炧	fopd
灼	fpi
𤆥	fpim
㷓	fpkp
灺	fpd
炖	fpu
煼	fpuu
煯	fppa
炮	fpru
煠	fptd
炂	fci
焧	fcip
脊	fcb
焍	fcnh
熷	fcwa
挙	fcq
焀	fcor
焆	frb
熉	frbc
煆	frse
㷷	fruc
炽	frc
燥	frrd
燀	frrj
煰	frrr
炾	frhu
炟	fam
焊	famj
煶	famo
煬	famh
焨	fab
煴	fabt
燘	fank
爛	fanw
熌	fano
燜	fanp
爓	fanx
熳	fawe
熶	fase
𤋉	fayi
燝	fayf
煜	fayt
熀	fafu
𤆵	fau
焜	fapp
焬	faph
燳	farf
焻	faa
煋	fahm
煝	fahu
焺	faht
爆	fate
爗	fatj
少	fh
炘	fhml
烐	fhbi
燠	fhbk
烐	fhby
省	fhbu
烅	fhbt
煈	fhni
炈	fhne
燬	fhge
㸆	fhgy
燻	fhgf
烍	fhgu
焅	fhgr
燆	fhkb
劣	fhks
秌	fhd
熪	fhdn
燔	fhdw
煍	fhdf
焮	fhlo
熜	fhwp
烽	fhej
炵	fhey
烙	fher
炉	fhs
炸	fhs
煽	fhsm
煸	fhsb
燩	fhsk
𤑛	fhsf
熩	fhsu
煄	fhjg
煅	fhje
𤊿	fhjx
烀	fhfd
爋	fhfs
灮	fhu
熄	fhup
𤓎	fhuc
烆	fhon
灹	fhp
焝	fhpa
𤊓	fhxu
㷆	fhrj
𤇢	fha
煌	fhag
熘	fhhw
焷	fhhj
灷	ft
煤	ftmd
燁	ftmj
煁	ftmv
𤊄	ftmc
𤐄	ftbf
燨	ftgi
爔	ftgs
㷽	ftgr
煐	ftlk
煂	ftlj
𤒈	ftlf
熯	ftlo
𤑳	ftlx
熿	ftlc
燇	ftwi
爡	ftwi
燤	ftwb
燶	ftwv
𤌚	ftwr
𤏸	ftja
烊	ftq
𤏲	ftqu
焫	ftob
爑	ftof
烵	ftpi
煫	ftpo
燪	ftpp
熑	ftxc
烘	ftc
烡	ftc
煪	ftcw
爜	ftce
爟	ftrg
焟	fta
爤	ftaw
山	u
乚	u
屸	um
亗	umm
屸	umm
岸	ummj
岏	ummu
嶏	ummu
峿	ummr
峌	umig
耑	umbl
峏	umbl
嶀	umbs
崸	umbc
峛	umnn
峢	umnn
嵿	umnc
㞹	umnr
岢	umnr
崕	umgg
崖	umgg
㟖	umgt
蚩	umli
峺	umlk
𡺉	umwg
崾	umwv
岅	ume
炭	umf
岯	umfm
屼	umu
嶜	umua
妛	umv
岈	umvh
嶳	umog
豳	umoo
岩	umr
豈	umrt
峘	umam
峫	umhl
㟲	umhf
岍	umt
巁	umtb
崋	umtj
嶡	umto
𡷑	uimo
嵾	uiih
嵻	uile
嵣	uilr
峬	uijb
鬯	uip
峻	uice
崀	uiav
𡷫	uihs
峸	uihs
𡻕	uihf
崴	uihv
嵅	uihr
嵗	uihh
岄	ub
岨	ubm
顓	ubmbc
嵈	ubme
嶾	ubmp
峒	ubmr
峝	ubmr
崩	ubb
酅	ubnl
歂	ubno
剬	ubln
剻	ubln
崢	ubsd
峴	ubuu
𡷹	ubuu
嵠	ubvk
崱	ubcn
巊	ubcv
崗	ubtu
峗	unmu
峞	unmu
嵹	unii
嶰	unbq
凾	unne
邖	unl
嶐	unlm
函	une
峥	unsd
嵥	unqd
崡	unue
嶝	unot
嶦	uncr
巉	unri
嶑	unao
岌	unhe
岋	unhe
凷	ug
嶻	ugig
嶹	ugni
崁	ugno
崶	uggi
嶢	uggu
嶤	uggu
峙	ugdi
崚	ugce
凶	uk
崎	ukmr
峟	ukb
峓	ukn
峚	ukg
崤	ukkb
崦	uklu
屴	uks
𡶐	uksr
輋	ukjj
峽	ukoo
嵽	ukpb
嶛	ukcf
嶚	ukcf
嶽	ukhk
兇	ukhu
峡	ukt
𡺨	udmq
嶘	udii
崊	udd
崠	udw
崬	udw
糶	udsmg
嵀	udyg
崍	udoo
崧	udci
嵖	udam
岥	udhe
屮	ul
屮	ul
岟	ulbk
岪	ulln
嶁	ullv
岫	ulw
嶁	ulwv
峍	ulq
岬	uwl
嵎	uwlb
嶧	uwlj
嶵	uwly
崓	uwjr
崮	uwjr
崽	uwp
凼	ue
汖	ue
顄	uembc
埊	ueg
崉	uea
嶍	usma
嵺	usmh
峮	uskr
岠	uss
崌	usjr
嶎	usfi
屺	usu
崛	usuu
㞾	usp
嶇	usrr
屻	ushi
岧	ushr
岹	ushr
崇	ujmf
豐	ujmrt
𡸜	ujbm
𡸽	ujbm
嵮	ujbc
孽	ujnd
孼	ujnd
峵	ujki
峔	ujkp
櫱	ujd
蠥	ujlmi
崨	ujlo
岐	uje
嶃	ujjl
嶄	ujjl
糱	ujfd
峖	ujv
岮	ujp
岤	ujc
崆	ujcm
巔	ujcc
嵱	ujcr
岵	ujr
崝	uqmb
𡻈	uqkd
𡵞	uqj
嶊	uqog
崹	uybb
巘	uybk
嵭	uybs
巃	uybp
巄	uybp
巐	uybt
崺	uysd
峐	uyvo
崒	uyoj
崪	uyoj
㠠	uypt
嵩	uyrb
嵉	uyrn
崞	uyrd
㠙	uyro
峕	uya
嵼	uyhm
嵃	uyhh
岦	uyt
巇	uyti
嶂	uytj
峷	uytj
巌	ufmk
峭	ufb
巀	ufgi
嶙	ufdq
嶸	uffd
嶗	uffs
巆	uffr
𡾡	ufua
𪑛	ufok
嵴	ufcb
乢	uu
出	uu
岀	uu
艸	uu
屾	uu
祟	uummf
嵦	uumt
欪	uuno
芳	uuyhs
粜	uufd
芔	uuu
茻	uuuu
𣁋	uuok
嵏	uuce
嵕	uuce
嶈	uvmi
幽	uvii
岰	uvis
崰	uvvw
崘	uomb
崙	uomb
崳	uomn
嵛	uomn
峑	uomg
嶮	uomo
峇	uomr
峆	uomr
岺	uoii
岭	uoii
岑	uoin
岒	uoin
嶺	uoic
嵢	uoir
屹	uon
崔	uog
巂	uogb
雟	uogb
嶲	uogs
𡼕	uogs
嶕	uogf
嶣	uogf
峳	uolk
岕	uoll
岝	uos
峜	uoym
嶖	uorm
嶷	upko
巓	upcc
岣	upr
峋	upa
岉	uphh
崟	uc
崯	uc
嶔	ucno
嶒	ucwa
岎	ucsh
峪	ucor
嶯	urji
辥	urytj
𡵆	uru
岷	urvp
嶉	urog
巖	urrk
巗	urrk
崿	urrs
嵓	urrr
崼	uamo
崵	uamh
𡼏	uana
岜	uau
峎	uav
嵑	uapv
崐	uapp
崑	uapp
嵋	uahu
匕	uh
巋	uhmb
岓	uhml
嵬	uhi
嵐	uhni
𡺤	uhni
𡶺	uhnb
岚	uhnk
峼	uhgr
岆	uhk
嶠	uhkb
嶓	uhdw
嵙	uhdj
崣	uhdv
嵊	uhdp
岴	uhlm
崥	uhwj
岅	uhe
峯	uhej
峰	uhej
𡶶	uheq
峂	uhey
峉	uher
峈	uher
岞	uhs
崜	uhjg
峨	uhqi
峩	uhqi
嵬	uhui
嵲	uhud
巑	uhuc
巍	uhvi
崻	uhoi
嶶	uhok
𡽪	uhok
嵂	uhoq
嵷	uhoo
嵸	uhoo
岻	uhpm
崏	uhpa
𡸣	uhxu
嶼	uhxc
嶭	uhrj
嵨	uhrf
岶	uha
崲	uhag
㟸	uhaj
嶋	uhaf
嶌	uhaf
峁	uhhl
嵧	uhhw
崥	uhhj
顗	utmbc
㠏	utmj
嵁	utmv
嵌	utmo
𡸷	utmc
獃	utik
覬	utbuu
酆	utnl
艷	utnau
嶬	utgi
豔	utgit
嵄	utgk
𡾞	utgs
豓	utkit
剴	utln
嶟	utwi
嶩	utwv
嶆	utwa
巈	utjd
嵯	utqm
敱	utye
嵫	utvi
敳	utok
嵰	utxc
嶪	utcd
嶫	utcd
崷	utcw
巏	utrg
嶱	utav
凱	uthn
颽	uthni
巕	uthv
女	v
妅	vm
妘	vmmi
牁	vmmnr
妧	vmmu
娠	vmmv
孋	vmmp
娪	vmmr
戕	vmi
姪	vmig
𤕸	vmig
狀	vmik
𡠭	vmbm
𡢅	vmbi
嬬	vmbb
媆	vmbk
將	vmbdi
彙	vmbwd
𡤕	vmbe
嫮	vmbs
孀	vmbu
奵	vmn
经	vmnom
妸	vmnr
壯	vmg
𡛼	vmgi
娾	vmgg
𡟹	vmgk
牆	vmgow
㚥	vmd
牀	vmd
婭	vmlm
蠿	vmlii
缆	vmliu
媔	vmwl
嫖	vmwf
婹	vmwv
奸	vmj
姸	vmjj
纬	vmqs
姃	vmym
统	vmyiu
嫣	vmyf
纺	vmyhs
妚	vmf
㚰	vmfm
嬭	vmfb
㛁	vmfj
彝	vmfft
娝	vmfr
𢑱	vmfhk
彜	vmfht
婳	vmuw
𡟺	vmue
妝	vmv
娙	vmvm
媷	vmvi
牄	vmoir
𡛦	vmob
娬	vmpm
彘	vmpop
妬	vmr
织	vmrc
𡟵	vmrr
姮	vmam
斨	vmhml
纤	vmhj
嫄	vmhf
妍	vmt
牂	vmtq
⼳	vi
厶	vi
幺	vi
醬	vimcw
獎	viik
嫏	viil
姢	vib
𡛻	vine
㛇	vig
墏	vig
奬	vik
妭	vikk
幼	viks
鴢	viksf
媯	vikf
樂	vid
槳	vid
嬤	vidi
嫲	vidd
孊	vidy
螿	vilmi
嫞	vilb
劙	viln
嫝	vile
㜍	vilr
畿	viw
漿	vie
幻	vis
娀	vij
嬷	viji
糸	vif
糹	vif
𢇃	vif
𢇁	vif
䊢	vifd
乣	viu
娏	viuh
𡛟	viv
以	vio
娭	viok
𨫥	vic
㛖	vice
始	vir
娘	viav
斷	vihml
幾	vihi
𡜐	vihi
发	vihe
娍	vihs
媙	vihv
嫬	vitf
嬚	vitc
姐	vbm
媛	vbme
姛	vbmr
姗	vbbm
姍	vbbm
嬡	vbbe
𡡞	vbbq
媧	vbbr
㛵	vbgb
婤	vbgr
㜣	vbkf
婇	vbd
𢑥	vbwd
婙	vbsd
媈	vbjj
𡛾	vbq
𡛓	vby
娊	vbuu
𡢞	vbuv
㛝	vbuc
娞	vbv
媱	vbou
孆	vbcv
嫇	vbac
婬	vbhg
嬀	vbhf
嫍	vbhx
姍	vbt
彑	vnm
嫋	vnmm
彔	vnme
姽	vnmu
彖	vnmo
姼	vnin
妤	vnin
姳	vnir
𡞵	vnbk
嫓	vnbp
媍	vnbc
妞	vng
娫	vnkm
娗	vnkg
好	vnd
邚	vnl
嫷	vnlb
婀	vnlr
𡟚	vnst
娹	vnyi
妳	vnf
煭	vnf
嬎	vnum
嬔	vnum
婏	vnui
奺	vno
婿	vnob
𡞳	vnok
嬁	vnot
㜬	vncr
娩	vnau
媃	vnhd
奶	vnhs
姌	vgb
嬄	vgbt
嬦	vgni
娃	vgg
嬈	vggu
奘	vgk
嬻	vgwc
㜜	vgsk
裝	vgyhv
焋	vgf
娤	vgv
嬙	vgow
娡	vgp
銺	vgc
婈	vgce
姞	vgr
嬯	vgrg
媴	vgrv
嬉	vgrr
𡣗	vgrr
婞	vgtj
媠	vkmb
姱	vkms
婍	vkmr
𡛕	vki
姷	vkb
盭	vkbt
姨	vkn
𡚺	vkni
𡘾	vkk
㛓	vkkb
𡛀	vke
嫉	vkok
𡠹	vkpb
嫽	vkcf
媁	vdmq
𡞫	vdmf
鄛	vdnl
妜	vdk
勦	vdks
㛦	vdd
𡢾	vddf
𡢟	vddo
娕	vdl
剿	vdln
嫩	vdlk
嫰	vdlo
嬾	vdlc
娻	vdw
媡	vdwf
妺	vdj
婡	vdoo
恏	vdp
𡜺	vdr
㜁	vdam
断	vdhml
凵	vl
爿	vlm
婔	vlmy
姚	vlmo
嬇	vlmc
嬧	vlmt
姎	vlbk
妉	vlbu
嫿	vlgm
蠁	vllmi
丱	vlllm
妯	vlw
妽	vlwl
娉	vlws
㜢	vlwv
収	vle
𡝯	vle
響	vlyta
饗	vloiv
收	vlok
婣	vlxl
姊	vlxh
嚮	vlhbr
㚼	vw
媦	vwb
娌	vwg
嫼	vwgf
姻	vwk
娚	vwks
𡟯	vwkp
婐	vwd
媀	vwlb
𡤢	vwlg
嬽	vwlk
嬕	vwlj
嬛	vwlv
㜥	vwlc
嫐	vwsv
疀	vwjlo
婟	vwjr
姆	vwyi
𡜼	vwyl
嫘	vwvf
媼	vwot
媤	vwp
鶅	vwhaf
奴	ve
砮	vemr
盝	vebt
弩	ven
媣	vend
孥	vend
努	veks
帑	velb
剝	veln
娺	veee
駑	vesqf
拏	veq
胬	veobo
怒	vep
𨥬	vec
㛥	vea
婦	vsmb
媉	vsmg
嬥	vsmg
嫪	vsmh
𥁒	vsbt
𡛂	vsk
嫕	vskp
𡝗	vskr
姫	vsll
姬	vsll
孎	vsei
𡠩	vseg
姖	vss
㛅	vsj
娵	vsje
婮	vsjr
娜	vsql
媽	vsqf
孎	vsyi
妃	vsu
妮	vsp
𡢡	vsrq
嬺	vsrp
嫗	vsrr
娓	vshu
妱	vshr
鶭	vshaf
㜊	vstv
嫟	vstr
𡟛	vstt
媗	vjmm
𡝬	vjmi
婃	vjmf
㛡	vjmu
嫁	vjmo
婝	vjmo
嬪	vjmc
𡤧	vjmc
嫥	vjii
姉	vjb
𡝮	vjbm
婻	vjbj
嫃	vjbc
婉	vjnu
㛈	vjks
姥	vjkp
媎	vjka
妹	vjd
𡜻	vjd
婕	vjlo
妓	vje
𡣑	vjuc
姲	vjv
嬣	vjpn
𡢠	vjcb
嫆	vjcr
姑	vjr
媩	vjrb
嫴	vjrj
娔	vjru
婠	vjrr
嬸	vjhw
姹	vjhp
𡤐	vjtc
婧	vqmb
嫊	vqmf
婊	vqmv
嫧	vqmc
嫀	vqkd
媋	vqka
妦	vqj
𡣺	vqjp
𡝰	vqyt
𡛨	vymy
娮	vymr
嬂	vyia
媂	vybb
嫎	vybs
媜	vybc
妵	vyg
妏	vyk
𡤅	vydu
姉	vylb
嬗	vywm
㜳	vywv
媫	vyso
嫙	vyso
婌	vyfe
妶	vyvi
姟	vyvo
𡢢	vypk
嫭	vypd
婋	vypu
𡣙	vyx
嫡	vycb
姣	vyck
嬢	vycv
㜲	vyrn
婷	vyrn
婛	vyrf
孃	vyrv
婥	vyaj
妔	vyhn
妨	vyhs
㛄	vyhv
𡠻	vyhr
媇	vytd
嫜	vytj
嬘	vyto
嬑	vytp
婄	vytr
紅	vfm
紜	vfmmi
纚	vfmmp
絰	vfmig
縉	vfmia
絚	vfmbm
繧	vfmbi
繻	vfmbb
緛	vfmbk
𦅙	vfmbk
纋	vfmbe
糽	vfmn
緻	vfmgk
紆	vfmd
緉	vfmlb
綆	vfmlk
繮	vfmwm
緸	vfmwg
緾	vfmwg
纒	vfmwg
緬	vfmwl
縹	vfmwf
絬	vfmjr
紑	vfmf
姯	vfmu
經	vfmvm
縟	vfmvi
絤	vfmcw
綇	vfmcw
𦂥	vfmre
絔	vfma
絙	vfmam
縓	vfmhf
絘	vfimo
綫	vfii
縿	vfiih
縛	vfibi
紎	vfik
紁	vfik
紱	vfikk
紌	vfiku
絒	vfill
纏	vfiwg
𦆲	vfish
絨	vfij
絿	vfije
絉	vfijc
紿	vfir
緎	vfirm
緿	vfirp
絾	vfihs
縬	vfihf
緘	vfihr
纊	vfitc
娋	vfb
組	vfbm
緩	vfbme
絧	vfbmr
嫦	vfbb
綳	vfbb
縎	vfbbb
綬	vfbbe
緺	vfbbr
綒	vfbnd
𡠠	vfbg
綢	vfbgr
綵	vfbd
𡡢	vfbd
㜭	vfbw
絼	vfbsh
緷	vfbjj
矕	vfbu
絸	vfbuu
繉	vfbuo
緲	vfbuh
綏	vfbv
𡣖	vfbv
縩	vfbof
纓	vfbcv
綗	vfbcr
絅	vfbr
縚	vfbhx
綱	vfbtu
網	vfbtv
彎	vfn
緑	vfnme
縁	vfnmo
紭	vfni
繈	vfnii
紓	vfnin
繲	vfnbq
紐	vfng
綖	vfnkm
綎	vfnkg
繺	vfnkf
孿	vfnd
紖	vfnl
䋼	vfnst
縃	vfnob
繦	vfnri
纔	vfnri
絻	vfna
絻	vfnau
絕	vfnau
絶	vfnau
繘	vfnhb
䋴	vfnhd
級	vfnhe
紶	vfgi
纎	vfgim
絓	vfgg
繞	vfggu
續	vfgwc
繬	vfgow
綕	vfgp
綾	vfgce
結	vfgr
纈	vfgrc
繥	vfgrr
緈	vfgtj
奱	vfk
絝	vfkms
綺	vfkmr
紘	vfki
絠	vfkb
䊵	vfkn
紈	vfkni
絺	vfkkb
糼	vfks
綊	vfkoo
𦄂	vfkpb
繚	vfkcf
欒	vfd
絊	vfdm
緯	vfdmq
紂	vfdi
緗	vfdbu
綝	vfdd
綀	vfdl
練	vfdwf
嫾	vfdq
𡞱	vfdv
紴	vfdhe
蠻	vflmi
緋	vflmy
絩	vflmo
繢	vflmc
𥿢	vflbi
紻	vflbk
紞	vflbu
繣	vflgm
紼	vflln
紃	vflll
繍	vflll
縷	vfllv
紬	vflw
紳	vflwl
縷	vflwv
絏	vflwp
繡	vflx
細	vfw
緭	vfwb
纆	vfwgg
絪	vfwk
綑	vfwd
綶	vfwd
纙	vfwlg
繹	vfwlj
繯	vfwlv
縲	vfwvf
縕	vfwot
緦	vfwp
絗	vfwr
縪	vfwtj
灓	vfe
経	vfeg
縔	vfeed
綴	vfeee
𦅛	vfsmi
綅	vfsme
繆	vfsmh
繿	vfsmt
䌫	vfsiu
繿	vfsit
纜	vfswu
緅	vfsje
𦀩	vfsje
紀	vfsu
𥿡	vfsp
糿	vfsh
紉	vfshi
絕	vfshu
紹	vfshr
𦂤	vfstt
縯	vfjm
縇	vfjmm
紵	vfjmn
𦅜	vfjmn
綜	vfjmf
綄	vfjmu
綻	vfjmo
縯	vfjmc
繽	vfjmc
纎	vfjim
縳	vfjii
繐	vfjip
綍	vfjbd
䋻	vfjbj
縝	vfjbc
綩	vfjnu
綋	vfjki
緒	vfjka
緖	vfjka
緀	vfjlv
緁	vfjlo
縖	vfjqr
縡	vfjyj
縮	vfjoa
紽	vfjp
𦆭	vfjpn
𦁈	vfjcm
綰	vfjrr
攣	vfq
姅	vfq
綪	vfqmb
縤	vfqmf
績	vfqmc
縥	vfqkd
綁	vfqjl
婘	vfqu
𡡀	vfqu
纉	vfqoc
繂	vfyij
統	vfyiu
織	vfyia
締	vfybb
縍	vfybs
緽	vfybc
紸	vfyg
繨	vfygq
紋	vfyk
䊼	vfylm
繾	vfylr
繵	vfywm
縗	vfywv
縼	vfyso
紏	vfyj
縺	vfyjj
縭	vfyub
絃	vfyvi
縴	vfyvq
絯	vfyvo
綷	vfyoj
纑	vfypt
絞	vfyck
縞	vfyrb
𦂃	vfyrn
綧	vfyrd
綡	vfyrf
纕	vfyrv
綽	vfyaj
紡	vfyhs
縫	vfyhj
縋	vfyhr
縌	vfytu
繸	vfyto
繶	vfytp
婒	vff
𤓖	vff
絖	vffmu
綃	vffb
緔	vffbr
嬫	vffd
繗	vffdq
絆	vffq
綣	vffqu
緂	vfff
𦇝	vffff
紗	vffh
巒	vfu
糺	vfu
繃	vfubb
𦆮	vfufk
絀	vfuu
纗	vfuob
繀	vfuog
緵	vfuce
孌	vfv
纅	vfvid
絲	vfvif
綠	vfvne
緣	vfvno
糾	vfvl
継	vfvfd
纞	vfvfp
繼	vfvvi
繅	vfvvd
緇	vfvvw
絵	vfomi
綸	vfomb
緰	vfomn
絍	vfomg
絟	vfomg
緶	vfomk
給	vfomr
繪	vfoma
纖	vfoim
紷	vfoii
紟	vfoin
𦁤	vfoip
納	vfob
臠	vfobo
紇	vfon
緱	vfonk
維	vfog
變	vfok
紨	vfodi
縧	vfold
紒	vfoll
絁	vfopd
緥	vford
緮	vfoae
絍	vfohg
紾	vfohh
纀	vfoto
戀	vfp
緪	vfpmm
約	vfpi
緫	vfpkp
純	vfpu
縐	vfpuu
綯	vfpou
紕	vfpp
絇	vfpr
絢	vfpa
紲	vfpt
緤	vfptd
鑾	vfc
総	vfcip
綈	vfcnh
繒	vfcwa
紛	vfcsh
綌	vfcor
綐	vfcru
縂	vfcrp
㘘	vfr
轡	vfr
絹	vfrb
縜	vfrbc
緝	vfrsj
縀	vfrye
繏	vfrvc
緡	vfrpa
繩	vfrxu
繰	vfrrd
繟	vfrrj
絽	vfrhr
曫	vfa
緹	vfamo
𦄡	vfabs
緼	vfabt
繝	vfanb
縵	vfawe
繓	vfase
緄	vfapp
緆	vfaph
妙	vfh
紤	vfhml
紝	vfhg
纁	vfhgf
繑	vfhkb
繙	vfhdw
綉	vfhds
緌	vfhdv
綼	vfhwj
總	vfhwp
綘	vfhej
絳	vfheq
終	vfhey
絡	vfher
編	vfhsb
繳	vfhsk
綟	vfhsk
䊹	vfhj
綞	vfhjm
緟	vfhjg
絑	vfhjd
緞	vfhje
紩	vfhqo
纘	vfhuc
紙	vfhvp
縰	vfho
絎	vfhon
縦	vfhoo
縱	vfhoo
綹	vfhor
緍	vfhpa
繌	vfhce
絈	vfha
綿	vfhab
線	vfhae
鸞	vfhaf
𪆓	vfhaf
鷥	vfhaf
綼	vfhhj
紺	vftm
綨	vftmc
繖	vftbk
繕	vftgr
緓	vftlk
緙	vftlj
緢	vftw
繜	vftwi
繷	vftwv
縙	vftsj
絴	vftq
縒	vftqm
纄	vftyj
繱	vftpp
縑	vftxc
緧	vftcw
縊	vftct
縸	vftak
絣	vftt
奾	vu
媸	vumi
媏	vumb
婩	vumj
嬍	vugk
媺	vuuk
孈	vuob
雝	vuog
𡡻	vuau
𡟶	vuhi
奻	vv
纟	vvm
𩠐	vvmbu
姧	vvmj
𡡤	vvii
㜰	vvid
姒	vvio
娽	vvne
𡟇	vvno
𡟼	vvno
甾	vvw
巢	vvwd
巤	vvwov
災	vvf
嬵	vvfb
𡤻	vvff
姦	vvv
巛	vvv
邕	vvrau
乆	vo
亾	vo
兦	vo
㚱	vom
嬆	vomm
婨	vomb
媮	vomn
姙	vomg
姾	vomg
媕	vomf
婾	vomv
嬐	vomo
娦	vomc
姶	vomr
嬒	voma
孅	voim
姈	voii
妗	voin
娢	voir
妠	vob
婎	vog
孇	voge
嫶	vogf
蠡	volii
剶	voln
妎	voll
娒	vowy
姩	voq
㜃	voyr
媬	vord
媕	vort
姙	vohg
鶨	vohaf
𡛧	vohh
嫵	votf
妁	vpi
㚬	vpim
𡟟	vpkp
她	vpd
婅	vpfd
媰	vpuu
妣	vpp
媘	vppa
姁	vpr
姰	vpa
妼	vph
𡛁	vphh
媟	vptd
卐	vx
妐	vci
𡟸	vcim
娣	vcnh
婵	vcwj
妢	vcsh
娧	vcru
如	vr
娱	vrmk
娟	vrb
桇	vrd
帤	vrlb
婽	vrse
挐	vrq
𢳉	vrq
娖	vryo
絮	vrvif
娛	vrvk
姄	vrvp
娯	vrvc
恕	vrp
孍	vrrk
嬠	vrrd
嬋	vrrj
鴽	vrhaf
妲	vam
媞	vamo
婸	vamh
𡝭	vab
媢	vabu
媪	vabt
嫺	vanb
𡢄	vank
嫻	vand
孄	vanw
𡢃	vana
嫚	vawe
𡡡	vayf
婫	vapp
娼	vaa
𡟙	vahm
媚	vahu
妡	vhml
姤	vhmr
𡚸	vhi
媿	vhi
鄉	vhiil
姂	vhio
𡜍	vhbu
姠	vhbr
姵	vhnb
𡠨	vhnh
妊	vhg
姺	vhgu
妖	vhk
嬌	vhkb
婖	vhkp
姀	vhd
娳	vhdn
嬏	vhdw
㛢	vhds
婑	vhdv
婢	vhwj
媲	vhwp
㛔	vhej
㚵	vhey
妒	vhs
妰	vhs
媥	vhsb
嬓	vhsk
鄊	vhsjl
奷	vhj
娷	vhjm
媑	vhjg
姝	vhjd
姡	vhjr
姓	vhqm
娥	vhqi
㚪	vhqu
妷	vhqo
媿	vhui
媳	vhup
㜺	vhuc
奼	vhp
婚	vhpa
嫂	vhxe
𡞲	vhxs
婗	vhxu
嬩	vhxc
嬹	vhxc
嬼	vhcn
𡤒	vhcq
郷	vhail
婂	vhab
媓	vhag
𡡅	vhaf
嬝	vhav
孂	vhat
㚹	vhhl
媹	vhhw
婢	vhhj
鄕	vhhpl
姏	vtm
媒	vtmd
嬅	vtmj
𡞴	vtmj
𡝴	vtmu
媅	vtmv
娸	vtmc
𡝳	vtio
媊	vtbn
婰	vtbc
𡟃	vtnu
嫅	vtgm
嬟	vtgi
媄	vtgk
𡤑	vtgw
𡡷	vtge
𡟜	vtgv
嫸	vtgr
婼	vtkr
嫤	vtlm
𡠪	vtlb
媖	vtlk
嬿	vtlf
嫨	vtlo
嫹	vtlc
媌	vtw
𡟻	vtwk
𡢿	vtwv
媶	vtsj
𡞰	vtvi
嬨	vtvp
嬳	vtoe
𡡣	vtpd
嫌	vtxc
娂	vtc
𡡒	vtcl
媨	vtcw
𡣘	vtco
𡝱	vtch
孉	vtrg
𡤃	vtab
嫫	vtak
𡤄	vtad
孏	vtaw
嬞	vthg
妌	vtt
姘	vtt
媾	vttb
人	o
㇏	o
亻	o
丘	om
亼	om
仝	om
仜	om
仁	omm
仨	ommm
会	ommi
伝	ommi
佘	ommf
佞	ommv
侲	ommv
僫	ommp
儷	ommp
俉	ommr
乓	omi
侄	omig
儒	ombb
俞	ombn
偄	ombk
侕	ombl
優	ombe
兪	ombv
愈	ombp
𢜒	ombp
侖	ombt
仃	omn
气	omn
侌	omni
例	omnn
侴	omnn
邱	omnl
歙	omno
何	omnr
仼	omg
全	omg
侢	omgb
倒	omgn
𠊷	omgk
㐵	omd
余	omd
伍	omdm
畬	omdw
峹	omdu
嵞	omdu
悆	omdp
俹	omlm
倆	omlb
𠉴	omlb
便	omlk
価	omlw
僵	omwm
傈	omwd
僳	omwd
偭	omwl
僄	omwf
僊	omwu
偠	omwv
價	omwc
會	omwa
卸	omsl
屔	omsp
仠	omj
钅	omjv
舍	omjr
佂	omym
傿	omyf
伓	omf
伾	omfm
儞	omfb
伻	omfj
俖	omfr
岳	omu
僭	omua
俓	omvm
傉	omvi
佤	omvn
伢	omvh
倵	ompm
兵	omc
合	omr
龠	omrb
命	omrl
偪	omrw
拿	omrq
搻	omrq
𥅽	omru
僉	omro
侸	omrt
佰	oma
𦉡	omami
乒	omh
儮	omhm
傆	omhf
侀	omtn
仏	oi
伐	oi
餪	oimbk
領	oimbc
飣	oimn
㺸	oimgi
飦	oimj
瓴	oimvn
佽	oimo
飡	oimoi
餖	oimrt
俴	oii
餞	oiii
餺	oiibi
饝	oiidr
餹	oiilr
餔	oiijb
饝	oiijr
餕	oiice
飴	oiir
傪	oiih
飷	oibm
餇	oibmr
傅	oibi
餶	oibbb
餫	oibjj
餒	oibv
饀	oibhx
今	oin
令	oini
䬷	oinin
𡦈	oindo
邻	oinl
酓	oinw
衾	oinv
飲	oino
念	oinp
貪	oinc
含	oinr
饞	oinri
餡	oinhx
盦	oint
垡	oig
饁	oigit
饐	oigbt
饒	oiggu
饎	oigrr
仪	oik
伏	oik
餙	oikkb
餚	oikkb
餣	oiklv
偽	oikf
优	oiku
𠇲	oid
餗	oidl
餷	oidam
蝕	oilmi
餆	oilmo
饋	oilmc
傭	oilb
䬬	oilbk
韱	oilsm
傏	oilr
餵	oiwmv
餜	oiwd
餟	oieee
翎	oismm
飼	oismr
餌	oisj
饇	oisrr
俌	oijb
餑	oijbd
𩟔	oijbf
饢	oijbv
俅	oije
餬	oijrb
館	oijrr
饙	oijtc
饖	oiymh
飳	oiyg
饘	oiywm
飰	oiyy
餃	oiyck
饟	oiyrv
餸	oiytk
餢	oiytr
饄	oifbg
饓	oifbd
餤	oiff
𩜠	oiumr
飿	oiuu
姇	oiv
饑	oivii
餯	oivno
餁	oiomg
餘	oiomd
俯	oioi
餱	oionk
餼	oiond
俟	oiok
飭	oioks
飾	oiolb
𩜲	oioae
代	oip
怤	oip
侙	oipm
儦	oipf
飩	oipu
飽	oipru
飶	oiph
俊	oice
餩	oicyo
佁	oir
饌	oiruc
餳	oiamh
飠	oiai
饂	oiabt
饅	oiawe
⻞	oiay
食	oiav
俍	oiav
餲	oiapv
餛	oiapp
倉	oiar
餉	oihbr
飢	oihn
飪	oihg
飫	oihk
餧	oihdv
飯	oihe
餎	oiher
飵	oihs
𠉛	oihs
餠	oihjj
餂	oihjr
侔	oihq
餓	oihqi
傶	oihf
餽	oihui
饡	oihuc
餰	oihon
飥	oihp
侂	oihp
餿	oihxe
餭	oihag
鴒	oihaf
飹	oihhl
餾	oihhw
饊	oitbk
饛	oitbo
餻	oitgf
饍	oitgr
饚	oitgt
餀	oitk
饉	oitlm
饈	oitqg
餝	oitys
饃	oitak
餅	oitt
內	ob
内	ob
仴	ob
伹	obm
龥	obmbc
俱	obmc
侗	obmr
倗	obb
傦	obbb
僾	obbe
僢	obbq
俘	obnd
龡	obno
隺	obg
偁	obgb
倜	obgr
倸	obd
𦒈	obsmm
佣	obq
㑾	obyr
俔	obuu
倶	obuc
俀	obv
龣	obvne
傒	obvk
肉	obo
傺	obof
傜	obou
憊	obp
龤	obppa
側	obcn
儩	obch
俷	obau
龢	obhd
𧈛	obhyu
僞	obhf
伔	obhu
鸙	obhaf
亇	on
乞	on
亿	on
𠆤	on
侯	onmk
氬	onmlm
佹	onmu
氫	onmvm
氥	onmcw
俑	onib
伃	onin
侈	onin
佲	onir
𠋀	onbs
覦	onbuu
偩	onbc
鄃	onnl
欦	onno
歈	onno
氖	onnhs
𡌅	ong
侹	onkg
鄇	onkl
健	onkq
仔	ond
氭	ondw
氕	onl
𠇁	onl
伄	onl
刉	onln
刏	onln
氘	onll
氟	onlln
氚	onlll
氠	onlwl
氤	onwk
𣱣	onwd
氳	onwot
𠐔	onwa
氨	onjv
氪	onjru
氰	onqmb
傑	onqd
氦	onyvo
你	onf
氣	onfd
氮	onff
氙	onu
氯	onvne
偦	onob
氝	onob
雂	onog
僜	onot
忥	onp
氛	oncsh
儋	oncr
儳	onri
氜	ona
氱	onamh
氲	onabt
俛	onau
像	onao
僪	onhb
伋	onhe
氡	onhey
仍	onhs
毹	onhqu
鳹	onhaf
氧	ontq
仕	og
玍	og
隹	og
顀	ogmbc
佉	ogi
儎	ogij
観	ogbuu
賃	ogbuc
儔	ogni
歓	ogno
隽	ognhs
佳	ogg
僥	oggu
勧	ogks
集	ogd
栠	ogd
侍	ogdi
雋	oglms
剉	ogln
儥	ogwc
雙	oge
隻	oge
傲	ogsk
隼	ogj
讐	ogymr
讎	ogyrg
焦	ogf
雔	ogog
雥	ogogg
雦	ogogg
𠓾	ogogg
雧	ogogd
恁	ogp
倰	ogce
售	ogr
舎	ogr
佶	ogr
儓	ogrg
僖	ogrr
𠏼	ogrr
凭	oghn
犫	oghq
犨	oghq
鵀	ogha
鵀	oghaf
䳡	oghaf
鶴	oghaf
倖	ogtj
攵	ok
矢	ok
佐	okm
侉	okms
倷	okmf
倚	okmr
短	okmrt
㑀	oki
俼	okib
侑	okb
仇	okn
侇	okn
𢻯	oknd
矧	oknl
鰵	oknwf
伜	oknj
俙	okkb
倄	okkb
傸	okkk
佈	oklb
侟	okld
俺	oklu
矲	okwlp
伖	oke
仂	oks
矩	okss
伽	oksr
倴	okjt
焂	okf
繁	okvif
雉	okog
俠	okoo
矬	okoog
悠	okp
慜	okp
鋚	okc
矰	okcwa
僚	okcf
知	okr
佑	okr
跾	okryo
俇	okhg
矨	okhk
矯	okhkb
矮	okhdv
瀪	okhae
𪄴	okhaf
鴙	okhaf
侠	okt
矱	oktoe
休	od
体	odm
偉	odmq
付	odi
賲	odbuc
堡	odg
僸	oddf
儊	oddo
倲	odw
𤲞	odw
叙	ode
糴	odsmg
敍	odye
斜	odyj
㷛	odf
煲	odf
烋	odf
雓	odog
敘	odok
𠓼	odoj
倈	odoo
怹	odp
恷	odp
鎥	odc
倯	odci
𠆫	odh
佊	odhe
鵂	odhf
个	ol
仲	ol
睂	olmbu
俳	olmy
佻	olmo
僓	olmc
儘	olmt
佒	olbk
候	olnk
介	oll
佛	olln
僂	ollv
伷	olw
伸	olwl
俜	olws
僂	olwv
侓	olq
翛	olom
脩	olob
攸	olok
倏	olok
條	olod
鞗	oloj
儵	olof
絛	olof
修	oloh
𠊞	olp
偝	olpb
偹	olhw
倐	olhf
佃	ow
偎	owmv
𠏋	owbp
俚	owg
侽	owks
倮	owd
偶	owlb
儸	owlg
儇	owlv
儡	owww
儽	owwf
毎	owj
𠍿	owjc
個	owjr
每	owyi
韽	owyta
傫	owvf
偲	owp
伵	owc
佪	owr
仅	oe
氽	oe
汆	oe
𠈹	oeok
乍	os
仺	osm
㑌	osmg
偓	osmg
㺱	osmgi
侵	osme
倀	osmv
伺	osmr
僇	osmh
儖	osmt
僝	osnd
伊	osk
侰	oskr
榘	osd
𠈄	osll
佢	oss
侷	ossr
佴	osj
倻	osjl
倨	osjr
傌	osqf
倔	osuu
伬	oso
怎	osp
伲	osp
僻	osrj
傴	osrr
偃	osav
𠍾	osav
仞	oshi
佋	oshr
偋	ostt
什	oj
午	oj
𠊿	ojmm
啎	ojmmr
佇	ojmn
倧	ojmf
俒	ojmu
傢	ojmo
𠉵	ojmo
儐	ojmc
傳	ojii
儎	ojij
僡	ojip
伂	ojb
值	ojbm
𠊙	ojbm
儾	ojbv
傎	ojbc
倇	ojnu
仗	ojk
侾	ojkd
𠐟	ojkf
佬	ojkp
偖	ojka
佅	ojd
俕	ojd
倳	ojln
使	ojlk
倢	ojlo
俥	ojwj
伎	oje
僌	ojjk
缶	oju
値	ojuv
侒	ojv
𠍅	ojon
佗	ojp
儜	ojpn
倥	ojcm
傛	ojcr
僒	ojcr
估	ojr
做	ojrk
倌	ojrr
侘	ojhp
鶽	ojhaf
𢒑	ojhhh
僿	ojtg
僨	ojtc
年	oq
倩	oqmb
傃	oqmf
俵	oqmv
債	oqmc
傣	oqke
俸	oqkq
偆	oqka
仹	oqj
伕	oqo
儧	oqoc
僣	oqoa
偰	oqhk
𠎧	oqhf
仆	oy
仩	oym
佧	oymy
佌	oymp
信	oymr
𠈔	oymt
偙	oybb
傍	oybs
儱	oybp
偵	oybc
住	oyg
㒓	oygq
伩	oyk
傚	oykk
俲	oyks
勄	oyks
儭	oydu
企	oylm
㑊	oylc
儃	oywm
𠍇	oyed
倣	oysk
偼	oyso
僆	oyjj
𠎀	oyqd
𣫺	oyyib
毓	oyyiu
俶	oyfe
僦	oyfu
禽	oyub
伭	oyvi
傗	oyvw
侫	oyvv
侅	oyvo
敏	oyok
倅	oyoj
偨	oypd
俿	oypu
儢	oypp
儕	oyx
佼	oyck
佔	oyr
傐	oyrb
停	oyrn
倞	oyrf
儴	oyrv
偯	oyrv
儫	oyro
儲	oyra
倬	oyaj
伉	oyhn
仿	oyhs
依	oyhv
緐	oyhvf
偐	oyhh
位	oyt
僮	oytg
傽	oytj
傹	oytu
𠎵	oyto
億	oytp
倍	oytr
偣	oyta
仦	of
伙	of
尓	of
尒	of
顦	ofmbc
侊	ofmu
甒	ofmvn
俏	ofb
㑽	ofbg
僘	ofbk
儅	ofbw
儻	ofbf
償	ofbc
倘	ofbr
鄦	ofnl
侎	ofd
籴	ofd
僯	ofdq
偻	ofdv
劁	ofln
畲	ofw
伴	ofq
儯	ofqf
倦	ofqu
倓	off
𠐓	offg
儝	offd
僗	offs
您	ofp
仯	ofh
偗	ofhu
鷡	ofha
鷡	ofhaf
鷦	ofhaf
仙	ou
仚	ou
屳	ou
缸	oum
偳	oumb
𩓥	oumbc
罈	oumwj
缻	oumvn
傰	oubb
罁	oubtu
缽	oudm
缺	oudk
罀	oulmo
罆	ouwjc
缷	ousl
㒥	oujt
罅	ouypd
𧇍	ouypu
罏	ouypt
缹	ouf
罉	oufbq
𦉘	oufbh
儶	ouob
侺	ouon
催	ouog
儍	ouce
罎	ouami
缿	ouhmr
罇	outwi
罐	outrg
缾	outt
僟	ovii
似	ovio
铜	ovbmr
钢	ovbk
欫	ovno
钟	ovl
锭	ovjmo
镇	ovjbc
儠	ovvv
铃	ovoii
侞	ovr
银	ovav
铁	ovhqo
仌	oo
从	oo
倫	oomb
顩	oombc
偷	oomn
佺	oomg
俆	oomd
偸	oomv
倹	oomo
儉	oomo
佮	oomr
儈	ooma
伶	ooii
仱	ooin
僋	ooic
傖	ooir
俎	oobm
傕	oobg
肏	oobo
仡	oon
歛	oono
坐	oog
倠	oog
夎	ooge
儁	oogs
㑺	oogs
僬	oogf
剣	ooln
劍	ooln
价	ooll
侮	oowy
作	oos
劔	oosk
劎	oosh
劒	ooshi
仵	ooj
𠍁	ooyk
伱	oof
佡	oou
众	ooo
侳	ooog
斂	oook
傘	oooj
𠈌	oooo
傷	ooah
儛	ootq
化	op
伈	op
伨	opmm
傾	opmc
伨	opim
貨	opbuc
貸	opbuc
垈	opg
儗	opko
偬	opkp
他	opd
柋	opd
帒	oplb
黛	opwgf
华	opj
袋	opyhv
岱	opu
伅	opu
㑳	opuu
敜	opok
仳	opp
偕	oppa
佝	opr
侚	opa
佖	oph
牮	ophq
伆	ophh
伳	opt
偞	optd
仈	oc
伀	oci
佾	ocb
俤	ocnh
僧	ocwa
份	ocsh
俗	ocor
侻	ocru
頜	ormbc
頷	ormbc
俣	ormk
盫	ormwt
戧	ori
舖	orijb
𥅽	orbu
傊	orbc
盒	orbt
舒	ornin
郃	ornl
欱	orno
保	ord
樖	ordmr
創	orln
佀	orlr
畣	orw
翕	orsmm
翖	orsmm
假	orse
偮	orsj
聟	orsj
舘	orjrr
拿	orq
搻	orqq
龕	orybp
敆	orye
促	oryo
僎	oruc
俁	orvk
𢜔	orp
僶	orxu
伿	orc
侣	orr
儼	orrk
偔	orrs
僤	orrj
鼅	orrxu
偘	orrr
智	ora
俋	orau
侱	orhg
侃	orhu
侶	orhr
鶬	orha
鶬	orhaf
鴿	orhaf
鵨	orhaf
弇	ort
但	oam
偍	oamo
偒	oamh
們	oan
僩	oanb
鄶	oanl
僴	oana
劊	oaln
僈	oawe
傝	oasm
𠎠	oayf
佷	oav
儑	oavf
偈	oapv
倱	oapp
倡	oaa
复	oahe
𠋥	oahu
儤	oate
入	oh
伒	ohml
仫	ohi
傀	ohi
侜	ohby
侐	ohbt
仉	ohn
偑	ohni
𠆩	ohni
佩	ohnb
伇	ohne
𠏵	ohnf
任	ohg
𠑥	ohgi
働	ohgs
侁	ohgu
俈	ohgr
仸	ohk
僑	ohkb
侨	ohkl
俬	ohdi
俐	ohdn
僠	ohdw
偢	ohdf
倭	ohdv
僁	ohdp
俰	ohdr
偊	ohlb
俽	ohlo
儨	ohlc
俾	ohwj
傯	ohwp
仮	ohe
俻	ohew
佭	oheq
佟	ohey
佫	oher
作	ohs
偏	ohsb
僱	ohsg
儌	ohsk
仟	ohj
倕	ohjm
偅	ohjg
侏	ohjd
倂	ohjj
偱	ohju
偛	ohjx
佸	ohjr
件	ohq
俄	ohqi
𠇔	ohqu
佚	ohqo
傂	ohyu
僽	ohfp
傀	ohui
儹	ohuc
仰	ohvl
係	ohvf
偫	ohoi
傱	ohoo
倃	ohor
偺	ohoa
低	ohpm
傁	ohxe
倪	ohxu
傻	ohce
𠌥	ohrf
伯	oha
偟	ohag
佄	otm
偡	otmv
倛	otmc
僙	otmc
儰	otif
偂	otbn
倎	otbc
舞	otniq
儀	otgi
僐	otgr
偌	otkr
橆	otdd
僅	otlm
偀	otlk
傼	otlo
㑤	otw
僔	otwi
㒖	otwb
儚	otwn
儂	otwv
傮	otwa
僼	otwt
𥂝	otwt
傇	otsj
佯	otq
傞	otqm
無	otf
儺	otog
僃	otpb
僷	otpd
傔	otxc
供	otc
偤	otcw
僕	otco
僛	otco
𠊠	otch
儆	otrk
借	ota
備	othb
𠍆	othn
併	ott
傋	ottb
心	p
㣺	p
忄	p
勻	pmm
忶	pmmi
忨	pmmu
悟	pmmr
恎	pmig
恆	pmbm
懦	pmbb
愞	pmbk
懮	pmbe
頃	pmbc
愩	pmbc
忊	pmn
忹	pmg
慄	pmwd
憟	pmwd
愐	pmwl
憛	pmwj
慓	pmwf
忓	pmj
怔	pmym
怀	pmf
怌	pmfm
怦	pmfj
匉	pmfj
憯	pmua
怲	pmob
恓	pmcw
匐	pmrw
愊	pmrw
恒	pmam
懨	pmak
勾	pi
勺	pi
匀	pim
勻	pim
慘	piih
愽	pibi
惨	pikm
忧	piku
惨	pikh
戂	pidy
慵	pilb
慷	pile
夣	piwln
匍	pijb
怵	pijc
惦	piyr
怴	piv
恜	pipm
悛	pice
怡	pir
惐	pirm
憾	pirp
悢	piav
慽	pihf
悈	pit
懭	pitc
怚	pbm
愋	pbme
懚	pbmp
惧	pbmc
恫	pbmr
愲	pbbb
懓	pbbe
墯	pbg
惆	pbgr
𢛵	pbsd
惲	pbjj
懼	pbug
戄	pbue
悓	pbuu
眞	pbuc
慀	pbvk
眞	pbvc
憏	pbof
愮	pbou
惻	pbcn
慏	pbac
慆	pbhx
𢜟	pbtu
惘	pbtv
乜	pn
恑	pnmu
匇	pni
悀	pnib
忬	pnin
恀	pnin
愌	pnbk
愑	pnbs
懈	pnbq
忸	png
𢛴	pndt
憜	pnlb
惤	pnyi
忺	pno
憕	pnot
憺	pncr
悗	pnau
憰	pnhb
忣	pnhe
怯	pgi
㦉	pgbt
懤	pgni
憢	pggu
恃	pgdi
慠	pgsk
懎	pgow
𢙺	pgp
恄	pgr
懛	pgrg
憘	pgrr
悻	pgtj
憉	pgth
匁	pk
忕	pk
惰	pkmb
𩓙	pkmbc
忲	pki
恞	pkn
勼	pkn
疑	pknio
忰	pknj
欵	pkno
匆	pkk
恡	pkki
悕	pkkb
慡	pkkk
怖	pklb
恠	pklg
𢙨	pkld
肄	pklq
㤿	pklu
匎	pklu
忇	pks
愶	pksb
恊	pkss
恢	pkf
愱	pkok
怱	pkp
憭	pkcf
也	pd
穎	pdmbc
愇	pdmq
忖	pdi
快	pdk
惏	pdd
憷	pddo
悚	pdl
懶	pdlc
乸	pdwyi
怶	pdhe
鵴	pdhaf
𪃸	pdhaf
忡	pl
悱	plmy
恌	plmo
憒	plmc
怏	plbk
忱	plbu
怫	plln
慺	pllv
怞	plw
懻	plpc
甸	pw
愄	pwmv
慖	pwim
㦙	pwbp
悝	pwg
𢞴	pwkp
惈	pwd
悃	pwd
愣	pwls
懌	pwlj
懁	pwlv
㦒	pwlr
慣	pwjc
慍	pwot
愢	pwp
怬	pwc
恛	pwr
潁	pembc
慅	peii
怪	peg
惙	peee
憳	psmi
恇	psmg
𢣷	psmg
悵	psmv
𢘜	psmr
慴	psma
憀	psmh
懢	psmt
懢	psit
愜	psko
慳	pseg
怇	pss
懾	psjj
怩	psp
慪	psrr
愝	psav
切	psh
忉	psh
怊	pshr
愃	pjmm
悰	pjmf
慱	pjii
憓	pjip
悖	pjbd
懥	pjbo
慎	pjbc
惋	pjnu
恅	pjkp
怽	pjd
悽	pjlv
忮	pje
駂	pjsqf
慚	pjjl
懧	pjpn
悾	pjcm
怙	pjr
悺	pjrr
愘	pjhr
鴇	pjhaf
憤	pjtc
情	pqmb
愫	pqmf
懳	pqjp
訇	pymr
𢚘	pymr
𢡠	pyia
𠣕	pyg
忟	pyk
悋	pykr
憞	pydk
憻	pywm
懍	pywd
懐	pywv
懷	pywv
慩	pyjj
忭	pyy
憱	pyfu
恼	pyuk
匄	pyv
忙	pyv
怰	pyvi
慉	pyvw
悴	pyoj
憈	pypm
懅	pypo
懠	pyx
恔	pyck
怗	pyr
悙	pyrn
惇	pyrd
惊	pyrf
懹	pyrv
悼	pyaj
忼	pyhn
㦀	pyhj
慥	pyhr
憧	pytg
慞	pytj
憶	pytp
愔	pyta
灳	pf
熲	pfmb
穎	pfmbc
頴	pfmbc
熲	pfmbc
顈	pfmbc
恍	pfmu
悄	pfb
憆	pfbg
戃	pfbf
惝	pfbr
匊	pfd
憐	pfdq
怑	pfq
惓	pfqu
慻	pfqu
惔	pff
憦	pffs
𢥏	pffr
悩	pfuk
屯	pu
惴	pumb
頓	pumbc
愷	pumt
邨	punl
鄒	punl
匈	puk
忷	puk
胷	pukb
皺	pudhe
刨	puln
炰	puf
雛	puog
慛	puog
芻	pupu
惾	puce
旾	pua
鶵	puhaf
㦡	pvid
怮	pvis
怓	pve
惱	pvvw
匃	pvo
勽	po
惀	pomb
愉	pomn
恮	pomg
悇	pomd
憸	pomo
恰	pomr
懀	poma
懺	poim
怜	poii
忴	poin
惗	poip
愴	poir
忔	pon
忾	pon
觺	ponbg
愾	pond
惟	pog
愯	poge
懏	pogs
憔	pogf
恘	pod
㤔	podi
忦	poll
悔	powy
怍	pos
忤	poj
匋	poju
愎	poae
慯	poah
憮	potf
㤈	pp
比	pp
愼	ppbc
坒	ppg
懝	ppko
愡	ppkp
忚	ppd
枈	ppd
粊	ppfd
忳	ppu
恟	ppuk
惢	ppp
橤	pppd
繠	pppf
毖	ppph
怐	ppr
怉	ppru
恂	ppa
恉	ppa
惸	ppad
怭	pph
毞	pphqu
惚	pphp
皆	ppha
怈	ppt
惵	pptd
惍	pc
忪	pci
慃	pcim
悌	pcnh
勩	pcks
惮	pcwj
憎	pcwa
𢣁	pcp
悅	pcru
悦	pcru
句	pr
吢	pr
悮	prmk
悁	prb
愪	prbc
够	prnin
邭	prnl
欨	prno
劬	prks
包	pru
悞	prvk
怋	prvp
雊	prog
敂	prok
惽	prpa
憴	prxu
懆	prrd
愕	prrs
憚	prrj
䵶	prrxu
悒	prau
斪	prhml
悜	prhg
怳	prhu
鴝	prhaf
旬	pa
旨	pa
怛	pam
悍	pamj
惿	pamo
愓	pamh
慨	paiu
愠	pabt
憪	panb
憫	pank
郇	panl
勓	paks
慢	pawe
憬	payf
愰	pafu
恨	pav
愒	papv
惃	papp
惕	paph
銞	pac
惺	pahm
鶛	pahaf
懪	pate
必	ph
忻	phml
𢘛	phmy
㤧	phmr
懊	phbk
甮	phbq
覕	phbuu
恦	phbr
恤	phbt
𢖯	phn
𢖾	phn
忛	phni
𢞁	phni
邲	phnl
慟	phgs
悎	phgr
憍	phkb
悿	phkp
憡	phdb
悧	phdn
悸	phdd
憣	phdw
愀	phdf
刎	phln
惞	phlo
懫	phlc
憁	phwp
恪	pher
惼	phsb
憿	phsk
悷	phsk
忏	phj
恬	phjr
性	phqm
怢	phqo
袃	phyhv
愧	phui
忯	phvp
忽	php
惛	phpa
懙	phxc
懰	phcn
怕	pha
曶	pha
惶	phag
勿	phh
匑	phhn
𢞖	phhk
匔	phhr
鴓	phhaf
世	pt
懄	ptms
㦊	ptmj
愖	ptmv
㥍	ptmc
貰	ptbuc
懞	ptbo
𢜪	ptkr
枼	ptd
慬	ptlm
慲	ptlb
愅	ptlj
懱	ptwi
懜	ptwn
懵	ptwu
憹	ptwv
慒	ptwa
𢤦	ptyg
慌	ptyu
恾	ptyv
懩	ptov
匒	ptor
憽	ptpp
慊	ptxc
懽	ptrg
惜	pta
慔	ptak
愺	ptaj
懂	pthg
恲	ptt
═	xm
鵛	xmmha
貢	xmbuc
鸍	xmbha
殥	xmnjm
恐	xmnp
鴷	xmnha
玊	xmgi
臹	xmgih
玥	xmgb
鄄	xmgnl
歅	xmgno
臻	xmgqk
珫	xmgyi
琀	xmgoi
玭	xmgpp
珌	xmgph
鳿	xmgha
憨	xmkp
垔	xmwg
鷣	xmjha
顠	xmfmb
覝	xmfbu
剢	xmoln
酃	xmrnl
泵	xmre
敔	xmrok
礣	xmrtw
郖	xmtnl
丶	xi
广	xi
亠	xim
剆	xiiln
宀	xib
鄘	xibnl
鷛	xibha
庋	xije
鄬	xifnl
慼	xifp
栥	xiod
庀	xip
麃	xipf
庇	xipp
鳶	xipha
怠	xirp
蠯	xihji
弁	xit
冖	xb
冂	xb
⺆	xb
⺝	xb
⺥	xb
⺼	xb
爫	xb
肛	xbm
刞	xbmln
脕	xbnau
鶪	xbkha
臅	xbwli
縢	xbfqf
覞	xbubu
瞚	xbujm
睢	xbuog
瞗	xbuha
郥	xbcnl
冗	xbhn
膬	xbhuu
⺄	xn
乛	xn
亅	xn
檃	xnmd
弘	xni
墮	xnbg
觔	xnbks
弔	xnl
陜	xnlko
氶	xne
鱴	xnftw
弢	xnue
久	xno
墬	xnog
弝	xnau
壖	xgmbb
劫	xgiks
彀	xgnhn
墝	xgggu
螫	xgklm
榖	xgdhn
垶	xgytj
鷇	xgfhn
堩	xgpmm
欯	xgrno
嘉	xgrtr
疒	xk
乂	xk
𠂇	xk
疘	xkm
冇	xkb
郁	xkbnl
夷	xkn
厹	xkni
痑	xknin
旮	xkna
痏	xkkb
鸑	xkkha
瘌	xkdln
瘏	xkjka
痲	xkjcc
疢	xkf
尢	xku
鴐	xkrha
癓	xkhok
痻	xkhpa
猏	xkhhs
羍	xktq
杠	xdm
槱	xdmwf
枑	xdmvm
棗	xdbdb
杼	xdnin
杍	xdnd
楺	xdnhd
杕	xdk
朹	xdkn
檶	xdksr
榃	xddw
檒	xddhn
柫	xdlln
梱	xdwd
框	xdsmg
檛	xdybb
榱	xdywv
梓	xdytj
檤	xdytu
╡	xdf
梒	xdoir
杺	xdp
构	xdpi
栺	xdpa
╣	xdr
柦	xdam
╢	xdh
杋	xdhni
板	xdhe
椼	xdhon
橁	xdhpa
丿	xl
║	xl
丨	xl
肀	xl
衤	xl
螾	xlijm
蝆	xlitq
幊	xlbmb
衶	xll
裍	xlwd
困	xwd
鷝	xwjha
╤	xwf
囮	xwop
毘	xwpp
╦	xwr
╥	xwh
氵	xe
氺	xe
澪	xembi
灞	xembb
湹	xemwg
沍	xemvm
洒	xemcw
鴻	xemhf
濂	xeitc
濉	xebug
懘	xebp
滘	xebcr
泓	xeni
沀	xenin
塣	xegg
濲	xegde
汯	xeki
氿	xekn
浠	xekkb
灗	xelim
沜	xelll
涃	xewd
沝	xee
洭	xesmg
演	xejmc
浨	xejd
濣	xejjj
漥	xejcg
濄	xeybb
瀛	xeynv
滖	xeywv
湤	xeysd
╕	xef
鍌	xeuc
瀹	xeomb
渝	xeomn
涻	xeomr
柒	xepd
汃	xec
╗	xer
沓	xea
灝	xeafc
╖	xeh
硰	xehmr
灚	xehbu
盪	xehbt
渢	xehni
淚	xehsk
瀩	xehuc
漇	xehoo
渵	xetw
汫	xett
𠃌	xs
翋	xsmyt
慰	xsip
屝	xslmy
臀	xseb
贀	xsebu
壂	xseg
嫛	xsev
繄	xsevi
憵	xsjp
╪	xsf
騂	xsfyt
已	xsu
妀	xsuv
╬	xsr
邵	xsrnl
鶋	xsrha
群	xsrtq
╫	xsh
戮	xshi
屧	xshod
屐	xshoe
鳭	xshha
╘	xzf
╚	xzr
╙	xzh
宀	xj
轛	xjjtg
剋	xjuln
寱	xjvmd
寣	xjvmr
鴳	xjvha
穵	xjcn
鷏	xjcha
鶷	xjrha
扌	xq
搣	xqihf
拸	xqnin
焎	xqlf
捰	xqwd
擢	xqsmg
鄻	xqjnl
撾	xqybb
摙	xqyjj
攍	xqyrw
╒	xqf
捨	xqomr
╔	xqr
╓	xqh
扷	xqhk
抓	xqhlo
洯	xqhe
揙	xqhsb
捩	xqhsk
恝	xqhp
亠	xy
辶	xy
⺀	xy
⺊	xy
⻌	xy
逜	xymmr
皻	xymdh
忐	xymp
甗	xybmv
欳	xybno
憝	xykp
鷟	xykha
敹	xydok
褱	xywlv
膂	xyvb
邋	xyvvv
劇	xyoln
龒	xypmm
礱	xypmr
迆	xypd
讋	xypym
鸗	xypha
齋	xyxf
奕	xyck
鶐	xycha
毫	xyrbu
詗	xyrbr
敁	xyrye
謯	xyryp
謪	xyryc
乩	xyru
詣	xyrpa
顏	xyhmb
迮	xyhs
鴗	xytha
⺌	xf
⺍	xf
灬	xf
敞	xfbok
炯	xfbr
炑	xfd
熤	xfsmt
熵	xfycb
顃	xffmb
熒	xffbf
爃	xfffd
焓	xfoir
烡	xftc
乚	xu
峏	xumbl
峸	xuihs
剻	xubln
峞	xunmu
岋	xunhe
嶚	xukcf
峖	xujv
峷	xuytj
艸	xuu
峆	xuomr
岭	xuoii
岒	xuoin
雟	xuogb
峰	xuhej
峈	xuher
槳	xvid
妤	xvnin
婝	xvjmo
紁	xvfik
絻	xvfna
縯	xvfjm
姅	xvfq
綟	xvfhs
縰	xvfho
鷥	xvfha
㇏	xo
亻	xo
仝	xom
侲	xommv
气	xomn
嵞	xomdu
怤	xoip
俍	xoiav
侂	xoihp
仴	xob
伄	xonl
隹	xog
栠	xogd
隻	xoge
恁	xogp
佶	xogr
犨	xoghq
鵀	xogha
侇	xokn
佑	xokr
鴙	xokha
烋	xodf
倏	xolok
絛	xolof
汆	xoe
午	xoj
僆	xoyjj
偯	xoyrv
尒	xof
鷡	xofha
仚	xou
倠	xoog
伈	xop
貸	xopbu
柋	xopd
伅	xopu
頷	xormb
鶬	xorha
僛	xotco
勹	xp
㣺	xp
忄	xp
愩	xpmbc
匉	xpmfj
愊	xpmrw
勺	xpi
勼	xpkn
悃	xpwd
忉	xpsh
熲	xpfmb
忷	xpuk
慛	xpuog
恉	xppa
旨	xpa
悷	xphsk
曶	xpha
忒	xxipp
囗	xxbm
膗	xxbuo
郩	xxkbn
瀜	xxemb
渥	xxesm
婜	xxsev
鵘	xxsrh
鳼	xxykh
顪	xxyhm
╧	xxf
屾	xxuu
鯈	xxolo
屳	xxou
鵨	xxorh
顈	xxpfm
鴯	xxxmb
麀	xxxip
鸆	xxxya
仜	xxxom
鵳	xxxhb
鴭	xxxhr
蘮	xxxtw
╩	xxr
鷐	xxavh
╨	xxh
鷽	xxhbh
鵚	xxhuh
鰴	xxhou
鵅	xxhrh
皞	xxhah
莰	xxtgn
藅	xxtwl
蔎	xxtyr
蓏	xxtho
卌	xxtt
丷	xc
銔	xcmfj
釴	xcip
弚	xcnl
鐊	xcnlh
釱	xck
鈦	xcki
釚	xckn
弅	xcsht
鎵	xcjmo
鏔	xcjmc
銃	xcyiu
鐹	xcybb
鋅	xcytj
╛	xcf
鋡	xcoir
鉓	xcolb
鈊	xcp
╝	xcr
╜	xch
釩	xchni
銩	xchgi
釽	xchlo
鳻	xchha
鑆	xctgi
唔	xrmmr
啀	xrmgg
唒	xrmcw
蹝	xrmho
唄	xrbuc
呔	xrki
叻	xrks
劋	xrdln
喔	xrsmg
咡	xrsj
鴞	xrsha
戢	xrji
嚓	xrjbf
喍	xrypd
啥	xromr
唅	xroir
咰	xrpa
叭	xrc
獸	xrrik
喿	xrrrd
邑	xrau
唳	xrhsk
囆	xrtwi
曰	xa
旰	xamj
暈	xabjj
欥	xano
冕	xanau
旼	xayk
晾	xayrf
╞	xaf
炚	xaf
顥	xafmb
旵	xau
昢	xauu
鷃	xavha
昒	xaphh
╠	xar
煦	xarf
昍	xaa
╟	xah
晑	xahbr
昈	xahs
⺮	xh
𠂆	xh
邸	xhmnl
籈	xhmgn
鷎	xhmha
么	xhi
顅	xhbmb
礐	xhbmr
爂	xhbf
嶨	xhbu
篹	xhbuu
鷮	xhbha
梨	xhnd
嶴	xhku
懲	xhkp
鄡	xhdnl
种	xhdl
剁	xhdln
秞	xhdlw
鷍	xhdha
笰	xhlln
鶹	xhwha
勹	xhs
籊	xhsmg
笸	xhsr
簙	xhjii
箎	xhypu
笘	xhyr
籩	xhyhs
釆	xhfd
郋	xhunl
憩	xhup
兟	xhuhg
鶞	xhuha
覣	xhvbu
彳	xho
黴	xhouf
瓝	xhopi
鴩	xhoha
筍	xhpa
鄮	xhcnl
劗	xhcln
郈	xhrnl
劄	xhrln
鴰	xhrha
癿	xhau
馫	xhaha
簃	xhhdn
卝	xt
䒑	xt
⺾	xt
艹	xt
蕶	xtmbi
鄞	xtmnl
薞	xtmnv
薽	xtmgn
芋	xtmd
菫	xtmlm
莤	xtmcw
芅	xtip
蒧	xtihr
顢	xtbmb
槊	xtbd
蒯	xtbln
茤	xtnin
蓩	xtnhs
羑	xtgno
蓺	xtggi
戁	xtgp
艽	xtkn
鄚	xtknl
鴱	xtkha
鷋	xtdha
鷰	xtlpf
曲	xtw
茵	xtwk
薎	xtwli
甍	xtwln
藣	xtwlp
藫	xtemj
萿	xtehr
藯	xtsip
苨	xtsp
苧	xtjmn
莞	xtjmu
萓	xtjbm
鄿	xtjnl
鞙	xtjrb
羋	xtq
薖	xtybb
藗	xtydo
蕸	xtyre
藹	xtyrv
蒟	xtytr
薅	xtvmi
孳	xtvid
蘥	xtomb
芞	xtomn
荅	xtomr
茌	xtog
茠	xtod
莝	xtoog
芶	xtpi
菳	xtc
歉	xtcno
惎	xtcp
莌	xtcru
鷬	xtcha
鄀	xtrnl
藒	xthdv
菞	xthdh
蓖	xthwp
菺	xthsb
蘅	xthon
藢	xthok
蓗	xthoo
蘤	xthaf
并	xtt
艵	xttna
蘳	xttcg
鵧	xttha
金	c
丷	c
釭	cm
釫	cmms
鈨	cmmu
鋠	cmmv
鐚	cmmp
𨰣	cmmp
鋙	cmmr
𨫎	cmii
銍	cmig
𨫌	cmia
鑐	cmbb
鐳	cmbw
𨯂	cmbv
顉	cmbc
𨫋	cmbc
釘	cmn
鈳	cmnr
鈓	cmg
鈺	cmgi
錱	cmgg
鑩	cmgr
釪	cmd
錏	cmlm
鐂	cmlw
鐔	cmwj
鏢	cmwf
𨪁	cmwv
銾	cme
鈪	cmsu
𨧧	cmso
釬	cmj
銒	cmjj
鉦	cmym
鈣	cmys
鈈	cmf
鉟	cmfm
鑈	cmfb
鋄	cmfe
𨥾	cmfj
銔	cmfj
鐕	cmua
鋞	cmvm
鎒	cmvi
兮	cmvs
釾	cmvh
鈵	cmob
憌	cmp
鉐	cmr
鎘	cmrb
鍢	cmrw
鋀	cmrt
銆	cma
鋣	cmhl
𨪛	cmhf
鶲	cmhaf
鈃	cmt
𨯅	cmtb
鉶	cmtn
鐝	cmto
公	ci
鈛	ci
頌	cimbc
瓮	cimn
𥗛	cimr
錢	cii
鎯	ciil
鏒	ciih
鎛	cibi
𨫆	cing
銢	cine
𨥭	cine
鈸	cikk
䤞	ciku
枀	cid
鏞	cilb
銂	cill
鏮	cile
鎕	cilr
翁	cism
鍽	cisb
鋪	cijb
銶	cije
龲	cijj
鉥	cijc
銭	ciq
鉞	civ
忩	cip
釴	cip
鉽	cipm
鑣	cipf
鋱	cipp
𨯙	cixe
𨭤	cixq
鏕	cixp
鋑	cice
鈶	cir
鋃	ciav
龯	cih
銊	cihm
鋮	cihs
鉾	cihq
鏚	cihf
兊	cihu
鈗	cihu
𨩆	cihv
鍼	cihr
鍍	cite
鏣	citf
鐮	citc
鑛	citc
鈅	cb
鉏	cbm
鍰	cbme
鋤	cbms
銅	cbmr
𥖹	cbmr
錋	cbb
鑀	cbbe
鍋	cbbr
鋢	cbnd
錭	cbgr
鋝	cbdi
𨰜	cbwi
錚	cbsd
鍕	cbjj
鉬	cbu
鑺	cbug
鐤	cbul
钁	cbue
鋧	cbuu
鋇	cbuc
鋖	cbv
鎐	cbou
鍘	cbcn
𨨥	cbcd
𨰃	cbcv
䤾	cbhx
銏	cbt
鋼	cbtu
龬	cbtv
釔	cn
録	cnme
䤥	cnmu
釸	cni
鏹	cnii
銿	cnib
鉹	cnin
𨥤	cnin
銘	cnir
𨥨	cnih
𨩉	cnbk
釕	cnn
鈕	cng
鋋	cnkm
鋌	cnkg
𨧞	cnkl
鍵	cnkq
釨	cnd
錳	cndt
鈏	cnl
弚	cnl
錒	cnlr
弟	cnlh
鐊	cnlh
鑥	cnwa
𨩙	cnst
𨧻	cnyi
欽	cno
鍨	cnok
鏺	cnoe
鐙	cnot
鑱	cnri
銫	cnau
鋔	cnau
鐌	cnao
鐍	cnhb
鍒	cnhd
鈒	cnhe
釢	cnhs
錎	cnhx
釷	cg
鉣	cgi
鎑	cgit
𨧣	cgbn
鑄	cgni
銈	cgg
鐃	cggu
鑟	cgwc
𨫼	cgsk
𨬓	cgov
鋕	cgp
錴	cgcg
錂	cgce
銡	cgr
𨯨	cgrf
鎱	cgrv
𨭎	cgrr
𨭌	cgth
父	ck
釱	ck
釜	ckmgc
銙	ckms
錼	ckmf
錡	ckmr
鈜	cki
鈦	cki
鋶	ckiv
銪	ckb
銕	ckn
釚	ckn
爹	cknin
鍷	ckgg
䤭	ckkb
鈽	cklb
銌	ckld
釛	cks
爺	cksjl
鉫	cksr
錛	ckjt
鋏	ckoo
鎩	ckce
鐐	ckcf
爸	ckau
斧	ckhml
鈢	cd
鉢	cdm
鍏	cdmq
𨦉	cdb
𨧀	cdg
鈌	cdk
鑻	cddq
𨭣	cddo
鋉	cdl
錬	cdw
鍊	cdwf
錰	cdf
錸	cdoo
釮	cdh
鈹	cdhe
丫	cl
鈡	cl
䤵	clmy
銚	clmo
鐀	clmc
鉠	clbk
鈂	clbu
釗	cln
鐨	clnc
鋛	cll
鉘	clln
釧	clll
鏤	cllv
鈾	clw
鉮	clwl
鏤	clwv
銉	clq
𨨩	clp
𨩈	clpb
鏽	clx
鈿	cw
鍡	cwmv
𨩋	cwb
鋰	cwg
𨭆	cwgf
銦	cwk
𨪜	cwkp
錁	cwd
鉀	cwl
鎠	cwlm
鐲	cwli
鍝	cwlb
鑼	cwlg
鐸	cwlj
鐶	cwlv
鑸	cwwg
鑘	cwww
𨯬	cwwv
单	cwj
鏆	cwjc
錮	cwjr
鉧	cwyi
鏍	cwvf
鎅	cwol
鍶	cwp
𨭦	cwrc
曾	cwa
鏎	cwtj
兾	cwtc
淾	ce
釵	cei
𨫟	ceid
鍅	cegi
𨨏	cede
𨥖	cee
鎟	ceed
錣	ceee
𨬡	cesd
錔	cea
鐋	ceah
鎃	cehv
𨩅	cetc
𨦫	csmm
鐞	csmi
鑃	csmg
鋟	csme
鑬	csmu
鋹	csmv
鉰	csmr
鏐	csmh
鑑	csmt
鑬	csiu
𨯿	csic
鑑	csit
𨧡	cskr
鉔	cslb
鑎	cslc
𨰹	cswc
钃	csei
鏗	cseg
鉅	css
鋦	cssr
鉺	csj
鎁	csjl
鋷	csje
鑷	csjj
銸	csju
鋸	csjr
鎷	csqf
钃	csyi
𨬯	csyq
𨥈	csu
鈮	csp
鉕	csr
䥲	csro
鏂	csrr
分	csh
釖	csh
釰	cshi
坌	cshg
炃	cshf
岔	cshu
麄	cshp
忿	cshp
貧	cshc
鉊	cshr
盆	csht
弅	csht
𨫀	cstv
針	cj
鍹	cjmm
𨬬	cjmw
錝	cjmf
鋎	cjmu
錠	cjmo
鎵	cjmo
鑌	cjmc
𨰦	cjmc
𨰰	cjmc
鏔	cjmc
鏄	cjii
鐵	cjig
鏸	cjip
鋍	cjbd
𨩇	cjbj
鎍	cjbf
鑔	cjbf
鎮	cjbc
鋺	cjnu
鋐	cjki
銬	cjks
銠	cjkp
鍺	cjka
鈘	cje
𨯪	cjjm
鏩	cjjl
𨪚	cjjj
鎋	cjqr
銨	cjv
䥑	cjon
鏥	cjoa
鉈	cjp
鑏	cjpn
鑹	cjcv
鎔	cjcr
鈷	cjr
鍸	cjrb
鋴	cjru
錧	cjrr
鑧	cjti
鑳	cjto
鐼	cjtc
錆	cqmb
錶	cqmv
𨨲	cqgi
鋳	cqki
銇	cqd
鏏	cqjm
𨧜	cqjl
𨯚	cqjp
鈇	cqo
鑚	cqoc
鐟	cqoa
鍥	cqhk
釙	cy
錹	cymb
鉲	cymy
鑡	cymu
𨦼	cymr
鐬	cymh
錥	cyib
鋶	cyiu
銃	cyiu
鍗	cybb
鐹	cybb
钀	cybk
鎊	cybs
鑨	cybp
鍞	cybc
鉒	cyg
鐽	cygq
鈫	cyk
鐓	cydk
鈰	cylb
鏀	cywi
鈙	cye
𨮏	cyed
鏃	cysk
鍦	cysd
鏇	cyso
鈄	cyj
鏈	cyjj
𨮹	cyyb
鉉	cyvi
錊	cyoj
鏬	cypd
鐪	cyps
鐻	cypo
鑢	cypp
鑪	cypt
鑇	cyx
鏑	cycb
𨫢	cycb
鉸	cyck
鉆	cyr
鎬	cyrb
𨧤	cyrn
𨪃	cyrn
錞	cyrd
鍄	cyrf
𨦸	cyru
鎄	cyrv
鑲	cyrv
𨮙	cyro
鋽	cyaj
鏟	cyhm
鈧	cyhn
鈁	cyhs
鏠	cyhj
銥	cyhv
䥥	cyhc
鎚	cyhr
鉝	cyt
鐘	cytg
鏱	cytj
鋅	cytj
鏡	cytu
鐩	cyto
鐿	cytp
錇	cytr
釥	cf
鈥	cf
╛	cf
銧	cfmu
銷	cfb
鏛	cfbb
鏜	cfbg
鏿	cfbd
鐺	cfbw
钂	cfbf
鎲	cfbu
鎖	cfbc
鑜	cfbc
鋿	cfbr
銤	cfd
鏻	cfdq
鉡	cfq
錈	cfqu
錟	cff
𨯗	cffg
鑅	cffd
鐒	cffs
𨫠	cfog
鈔	cfh
釓	cu
𨥉	cu
鍴	cumb
錌	cumj
鎧	cumt
鏰	cubb
鈯	cuu
鑴	cuob
鏙	cuog
敓	cuok
敚	cuok
鍐	cuce
𨬌	cuap
鎽	cuhj
毤	cuhqu
𨬫	cutn
釹	cv
鏘	cvmi
鍿	cvmw
鐖	cvii
鑠	cvid
鉯	cvio
錄	cvne
鐑	cvfr
鏁	cvvd
錙	cvvw
鑞	cvvv
鎻	cvvc
銣	cvr
釞	co
錀	comb
鑰	comb
鍮	comn
銓	comg
𨨶	coml
鎿	comq
鐱	como
鋲	comc
鉿	comr
鑯	coim
鈴	coii
鈐	coin
錜	coip
鎗	coir
鋡	coir
鈉	cob
釳	con
鍭	conk
鎎	cond
𨫡	conq
錐	cog
鏶	cogd
鎸	cogs
鐫	cogs
鎨	cogj
鐎	cogf
銝	cod
鉜	codi
螸	colmi
鏅	colb
鈽	colb
鉓	colb
鎀	colh
鋂	cowy
銼	coog
慾	cop
鈋	cop
谷	cor
𨩚	cord
鍑	coae
銋	cohg
𨦪	cohl
鉁	cohh
鈊	cp
鈞	cpmm
釣	cpi
鈎	cpi
鈞	cpim
鎭	cpbc
釶	cpd
鍧	cpyr
鈍	cpu
鋾	cpou
鈚	cpp
鍇	cppa
鉤	cpr
鉋	cpru
銁	cpa
鉍	cph
鍃	cphp
鉪	cpt
鍱	cptd
釟	cc
鍂	cc
鈆	cci
鎓	ccim
銻	ccnh
鏳	ccwa
鈖	ccsh
鋊	ccor
鑫	ccc
𨰻	cccc
鉛	ccr
銳	ccru
鋭	ccru
𪄇	cchaf
釦	cr
╝	cr
豃	crmjk
谺	crmvh
鏴	crmr
鋗	crb
豀	crbvk
郤	crnl
谻	crnq
欲	crno
豄	crgwc
谹	crki
銱	crlb
鈻	crlr
豂	crsmh
卻	crsl
鍜	crse
鍓	crsj
谾	crjcm
豅	crybp
鍜	crye
鋜	cryo
釲	cru
鐉	cruc
鋘	crvk
鈱	crvp
谽	croir
总	crp
懖	crp
𢤹	crp
鍲	crpa
鉙	crc
𨰫	crrk
鐰	crrd
鍔	crrs
𨭐	crrj
鋥	crhg
兌	crhu
兑	crhu
鋁	crhr
鵒	crhaf
谼	crtc
鈤	ca
鉭	cam
鍀	cami
銲	camj
甑	camvn
鍉	camo
鍚	camh
𨧹	cab
鍆	can
鐗	canb
鄫	canl
鑭	canw
鐧	cana
𠕇	cana
䒏	canau
鐦	cant
鏝	cawe
鎉	casm
鐛	cayf
𨩄	cayt
鎤	cafu
鈀	cau
銀	cav
䥪	cavf
𨫞	caop
鍻	capv
錕	capp
錫	caph
朆	caphh
錩	caa
鍟	cahm
鎇	cahu
鑤	cate
╜	ch
頒	chmbc
釿	chml
瓫	chmvn
銗	chmr
麄	chixp
鐭	chbk
銄	chbr
釠	chn
𡯂	chn
𩗩	chni
釩	chni
𨦨	chnb
䤪	chnd
鏫	chnd
邠	chnl
鈠	chne
鈓	chg
銩	chgi
鑂	chgf
銑	chgu
鋯	chgr
鐈	chkb
鉌	chd
鏼	chdb
鋓	chdn
𨧺	chdl
鐇	chdw
銹	chds
鍬	chdf
錗	chdv
鏭	chdp
銹	chdh
蚠	chlmi
剃	chln
鍁	chlo
釽	chlo
鑕	chlc
錍	chwj
鎞	chwp
鏓	chwp
鈑	che
鋒	chej
鉖	chey
鉻	cher
鈼	chs
鍽	chsb
釺	chj
錘	chjm
鍾	chjg
銖	chjd
鍛	chje
鍎	chju
鍤	chjx
銛	chjr
鉎	chqm
鋨	chqi
鉄	chqo
尣	chu
鎳	chud
鎴	chup
鑽	chuc
𨯩	chua
鈲	chvo
攽	chok
鏦	choo
𢚖	chp
錉	chpa
鎪	chxe
𨯵	chxc
銵	chxh
鎢	chrf
鉑	cha
錦	chab
鍠	chag
䤼	chae
鵭	chaf
𨰝	chaa
鉚	chhl
鎦	chhw
鑗	chhe
錍	chhj
鵜	chhaf
鳻	chhaf
釤	chhh
𨰉	chtl
鉗	ctm
鏵	ctmj
鍖	ctmv
錤	ctmc
鐄	ctmc
鐝	ctmto
鑶	ctis
鎆	ctbn
鏾	ctbk
錪	ctbc
鑆	ctgi
鎂	ctgk
錓	ctgu
𨬢	ctgo
鐥	ctgr
鑉	ctgt
鍩	ctkr
鏋	ctlb
鍈	ctlk
𨯧	ctlf
𨫪	ctlo
錨	ctw
鐏	ctwi
鑖	ctwi
𨭬	ctwb
鏪	ctwa
鑮	ctei
鍣	ctsr
鎈	ctqm
鑝	ctyj
鋩	ctyv
鎙	ctub
鎡	ctvi
𨧨	ctob
鑊	ctoe
錵	ctop
鎝	ctor
鐷	ctpd
𨪂	ctpo
鎌	ctxc
鉷	ctc
䥓	ctcg
𨭥	ctcd
鐁	ctcl
𨩊	ctcw
𨬭	ctcu
鏷	ctco
鐠	ctca
𨧼	ctch
鎰	ctct
鑵	ctrg
𨯫	ctrs
錯	cta
鏌	ctak
钄	ctaw
鉼	ctt
〇	r
口	r
蹰	rmmmi
䟴	rmmmv
躧	rmmmp
呍	rmmi
跮	rmmig
跒	rmmnr
𨆼	rmmgi
趶	rmmd
𨁈	rmmlk
呩	rmmf
躎	rmmfb
踎	rmmfr
㖘	rmmv
踁	rmmvm
噁	rmmp
囇	rmmp
跴	rmmcw
跖	rmmr
唔	rmmr
踾	rmmrw
𨂽	rmmre
趼	rmmt
蹶	rmmto
踐	rmii
咥	rmig
躕	rmigi
跋	rmikk
躔	rmiwg
𨃩	rmism
踮	rmiyr
蹗	rmixp
踆	rmice
跆	rmir
踉	rmiav
踱	rmite
蹠	rmitf
跀	rmb
跙	rmbm
𠽌	rmbm
嘠	rmbi
嚅	rmbb
𨂃	rmbb
𨃴	rmbbb
踻	rmbbr
嚯	rmbg
蹨	rmbkf
踩	rmbd
嚘	rmbe
踭	rmbsd
躣	rmbug
躩	rmbue
蹊	rmbvk
嗊	rmbc
蹈	rmbhx
跚	rmbt
叮	rmn
跪	rmnmu
踊	rmnib
跢	rmnin
踴	rmnbs
咧	rmnn
踺	rmnkq
蹳	rmnoe
蹬	rmnot
呵	rmnr
蹫	rmnhb
蹂	rmnhd
趿	rmnhe
踋	rmgil
噖	rmgn
躊	rmgni
跬	rmgg
啀	rmgg
蹺	rmggu
跱	rmgdi
跿	rmgyo
踛	rmgcg
踜	rmgce
哢	rmgt
吴	rmk
跨	rmkms
踦	rmkmr
跠	rmkn
跏	rmksr
蹛	rmkpb
吁	rmd
嚦	rmdm
趹	rmdk
踈	rmdl
𨂐	rmdoo
蹅	rmdam
跛	rmdhe
啞	rmlm
跳	rmlmo
蹪	rmlmc
啢	rmlb
哽	rmlk
跩	rmlwp
𨀞	rmlq
喱	rmwg
踝	rmwd
喕	rmwl
躅	rmwli
嘾	rmwj
躀	rmwjc
𧿹	rmwyi
嘌	rmwf
喓	rmwv
𠿪	rmwc
蹕	rmwtj
䟕	rmei
踏	rmea
躍	rmsmg
蹘	rmsmh
𨈇	rmswu
距	rmss
跼	rmssr
踙	rmsje
躡	rmsjj
踂	rmsju
踞	rmsjr
呃	rmsu
跽	rmsup
啄	rmso
跜	rmsp
躃	rmsrj
蹍	rmstv
𨀉	rmjmn
踪	rmjmf
𨂾	rmjbj
蹎	rmjbc
踠	rmjnu
噉	rmjk
踍	rmjkd
跊	rmjd
踕	rmjlo
跂	rmje
咞	rmjj
蹜	rmjoa
跎	rmjp
躥	rmjcv
跍	rmjr
蹟	rmqmc
蹖	rmqkx
踳	rmqka
𨀤	rmqd
趺	rmqo
吓	rmy
躚	rmymu
跐	rmymp
𨄮	rmyij
蹄	rmybb
躘	rmybp
跓	rmyg
躂	rmygq
蹾	rmydk
趾	rmylm
跡	rmylc
踄	rmylh
蹥	rmyjj
嘕	rmyf
踧	rmyfe
蹴	rmyfu
踤	rmyoj
躆	rmypo
躋	rmyx
蹢	rmycb
跤	rmyck
跕	rmyr
躟	rmyrv
踔	rmyaj
蹆	rmyav
趽	rmyhs
蹱	rmytg
踥	rmytv
踣	rmytr
吥	rmf
呸	rmfm
踃	rmfb
蹚	rmfbg
𨆉	rmfbw
䠀	rmfbr
𨅝	rmfbh
蹸	rmfdq
呯	rmfj
跘	rmfq
踡	rmfqu
躞	rmffe
蹐	rmfcb
𠳝	rmfr
踹	rmumb
嘎	rmui
蹦	rmubb
𠵾	rmuw
嗄	rmue
噆	rmua
𨅏	rmuhi
蹡	rmvmi
嗕	rmvi
躖	rmvim
躒	rmvid
咓	rmvn
号	rmvs
叿	rmvs
躐	rmvvv
呀	rmvh
踚	rmomb
踰	rmomn
跧	rmomg
跲	rmomr
𡁷	rmoi
跉	rmoii
趻	rmoin
踗	rmoip
蹌	rmoir
趷	rmon
踓	rmog
踟	rmokr
跗	rmodi
踇	rmowy
𨀣	rmoym
𠶲	rmou
踨	rmooo
跈	rmohh
躌	rmotq
𨆯	rmoto
蹞	rmpmc
趵	rmpi
踘	rmpfd
跔	rmpr
跑	rmpru
跇	rmpt
蹀	rmptd
趴	rmc
哂	rmcw
唒	rmcw
蹭	rmcwa
𠰴	rmr
嗝	rmrb
𠹶	rmrj
踀	rmryo
𠹭	rmrr
躁	rmrrd
哣	rmrt
咟	rma
咺	rmam
踶	rmamo
踼	rmamh
躢	rmanm
躙	rmang
躝	rmanw
蹋	rmasm
跁	rmau
跟	rmav
踢	rmaph
嚦	rmhm
斲	rmhml
跅	rmhmy
跺	rmhnd
跣	rmhgu
跃	rmhk
蹻	rmhkb
蹯	rmhdw
踿	rmhdf
踒	rmhdv
踽	rmhlb
躓	rmhlc
跭	rmheq
路	rmher
䟭	rmhs
蹁	rmhsb
躈	rmhsk
踵	rmhjg
跦	rmhjd
踲	rmhju
跌	rmhqo
蹏	rmhyu
躦	rmhuc
蹤	rmhoo
蹝	rmhoo
蹓	rmhhw
䠋	rmhhj
咞	rmt
𨅯	rmtmj
踸	rmtmv
踑	rmtmc
𡂖	rmtb
躑	rmtkl
蹃	rmtkr
蹣	rmtlb
蹲	rmtwi
蹧	rmtwa
躇	rmtja
蹉	rmtqm
躤	rmtqa
噘	rmto
躨	rmtce
蹼	rmtco
踖	rmta
躪	rmtag
跰	rmtt
踫	rmttc
𠯫	ri
唥	rimi
啷	riil
嘇	riih
𠹌	ribp
咏	rine
吠	rik
噅	rikf
嚒	ridi
嚤	ridq
嘃	rilb
㖄	rill
哺	rijb
嘛	rijc
𠶧	riyr
𡁜	rifb
𡅏	rift
哤	riuh
雖	riog
唉	riok
𠳓	ripp
唆	rice
咍	rir
哴	riav
哞	rihq
嘁	rihf
吮	rihu
喴	rihv
喊	rihr
喥	rite
嗻	ritf
嚝	ritc
肙	rb
咀	rbm
喛	rbme
瓹	rbmvn
哃	rbmr
嗗	rbbb
噯	rbbe
喎	rbbr
哹	rbnd
啁	rbgr
嘫	rbkf
啋	rbd
哷	rbdi
剈	rbln
嚼	rbwi
嗣	rbsmr
𠲜	rbsd
𠱂	rbss
喗	rbjj
𡄯	rbyp
哯	rbuu
員	rbuc
唄	rbuc
哸	rbv
嗘	rbvk
嗂	rbou
嚶	rbcv
㗖	rbhx
鵑	rbhaf
𠹻	rbtk
𠱓	rnmu
哆	rnin
𠰻	rniy
𠱷	rnir
唃	rnbg
𡃏	rnbg
喚	rnbk
嘝	rnbj
𠮩	rnn
吜	rng
𡋾	rng
唌	rnkm
吇	rnd
吼	rndu
𠵼	rndt
吲	rnl
唨	rnlm
𠾐	rnlm
𡃴	rnlb
𡁸	rnlf
啊	rnlr
嚕	rnwa
𠱁	rne
喼	rnsp
𠹳	rnqd
吹	rno
噔	rnot
𪚩	rnxu
噡	rncr
嚵	rnri
噊	rnhb
吸	rnhe
𠮨	rnhs
啗	rnhx
吐	rg
呿	rgi
𠲵	rgis
嗑	rgit
呥	rgb
噎	rgbt
嚋	rgni
郢	rgnl
哇	rgg
啩	rggy
嘵	rggu
嚽	rgkc
哧	rglc
𠹺	rgwg
𡂝	rgwc
嗷	rgsk
唗	rgyo
𡁻	rgob
𠺬	rgou
哋	rgpd
嚇	rgcc
咭	rgr
嘻	rgrr
鷕	rghaf
啈	rgtj
嘭	rgth
咗	rkm
咵	rkms
𠵇	rkmr
吰	rki
呔	rki
哊	rkb
喐	rkbl
睯	rkbu
咦	rkn
喹	rkgg
唏	rkkb
咘	rklb
唵	rklu
另	rks
叻	rks
嗋	rksb
𠸊	rksj
咖	rksr
喯	rkjt
咴	rkf
𡁯	rkoi
唊	rkoo
愍	rkp
嘹	rkcf
㗎	rkrd
𡃉	rkrf
暋	rka
唙	rkhf
㕲	rd
呆	rd
呠	rdm
𠶖	rdmg
𠼰	rdmk
喡	rdmq
吋	rdi
鄵	rdnl
吷	rdk
啉	rdd
噤	rddf
喇	rdln
劋	rdln
嗽	rdlo
𡃤	rdlc
喖	rdjr
𠾴	rdqq
𠵉	rdyn
唻	rdoo
槑	rdrd
𡀞	rdrj
喳	rdam
氉	rdhqu
𠺝	rdhr
虽	rlmi
啡	rlmy
咷	rlmo
嘳	rlmc
嚍	rlmt
吊	rlb
咉	rlbk
㗲	rlgm
咈	rlln
嘨	rlll
嘍	rllv
呻	rlwl
黾	rlwu
嘍	rlwv
哶	rlyj
𠸐	rlon
嘯	rlx
喂	rwmv
嘓	rwim
喟	rwb
鄙	rwnl
哩	rwg
嘢	rwgn
嚜	rwgg
嘿	rwgf
咽	rwk
𠲸	rwks
嗯	rwkp
呷	rwl
噣	rwli
喁	rwlb
囉	rwlg
噮	rwlv
嘪	rwlc
𠴱	rwjr
呣	rwyi
𠼱	rwvf
嗢	rwot
呬	rwc
㖥	rwhd
嗶	rwtj
叹	re
𠺘	reiv
𠿭	rebb
啵	rede
嗓	reed
啜	reee
𡄽	rejf
唦	refh
嗨	reoy
𠴲	rea
𠻹	rehp
叼	rsm
噚	rsmi
顎	rsmbc
哐	rsmg
嚁	rsmg
喔	rsmg
唚	rsme
噿	rsmj
嘐	rsmh
嚂	rsmt
嚂	rsit
唰	rsbn
鄂	rsnl
吚	rsk
叩	rsl
咂	rslb
別	rsln
别	rsln
𠱸	rsll
囑	rsei
𡁵	rsef
𠰠	rss
卾	rssl
叚	rsse
𠱃	rssu
咠	rsj
咡	rsj
㖿	rsjl
囁	rsjj
啹	rsjr
哪	rsql
嗎	rsqf
囑	rsyi
號	rsypu
𤏩	rsf
啒	rsuu
呎	rso
飸	rsomv
呢	rsp
噼	rsrj
𡂿	rsro
嘔	rsrr
叨	rsh
嘱	rshb
𠳿	rshu
鶚	rshaf
鴞	rshaf
叶	rj
喧	rjmm
辴	rjmmv
唍	rjmu
啶	rjmo
𠺢	rjmo
戰	rji
戢	rji
𡁶	rjig
𠵌	rjbm
哱	rjbd
喃	rjbj
嗦	rjbf
嚓	rjbf
囔	rjbv
嚏	rjbo
嚔	rjbo
嗔	rjbc
鄲	rjnl
啘	rjnu
哮	rjkd
𠱼	rjks
咾	rjkp
啫	rjka
味	rjd
嘋	rjdk
啑	rjlo
唓	rjwj
吱	rje
囅	rjstv
囀	rjji
𠽤	rjji
嘲	rjjb
𡆀	rjjj
嗐	rjqr
咹	rjv
嘜	rjon
咜	rjp
嚀	rjpn
嘧	rjpu
嗜	rjpa
啌	rjcm
噾	rjca
咕	rjr
㗅	rjrb
𠳭	rjru
𡅅	rjrc
𠴨	rjrr
嘟	rjal
哰	rjhq
咤	rjhp
喀	rjhr
鷤	rjhaf
𠱥	rjt
噻	rjtg
噴	rjtc
𠻺	rqmm
啨	rqmb
咑	rqmn
嗉	rqmf
嘖	rqmc
𡃁	rqbu
𠳖	rqne
嗪	rqkd
唪	rqkq
𠾵	rqdm
𠵿	rqde
嘒	rqjm
嚖	rqjp
𠳏	rqym
𡃵	rqyg
唞	rqyj
啦	rqyt
𠳕	rqfh
呋	rqo
𠵆	rqam
喫	rqhk
哳	rqhl
𡃓	rqhw
噄	rqhf
囓	rqhu
啪	rqha
卟	ry
啃	rymb
咔	rymy
嚙	rymu
呲	rymp
唁	rymr
噦	rymh
唷	ryib
𠾍	ryid
㗻	rybb
啼	rybb
嗙	rybs
嚨	rybp
嗵	rynb
𠰍	ryg
噠	rygq
呅	ryk
囃	rydg
噋	rydk
噺	rydl
嚫	rydu
⻊	rylm
嚃	rywe
𠺖	rywo
啚	rywr
嗾	rysk
叚	ryse
唹	rysy
𠸝	ryso
呌	ryj
嗹	ryjj
噈	ryfu
𠻗	ryub
呟	ryvi
噰	ryvg
咳	ryvo
足	ryo
㖡	ryok
𡃀	ryoe
啐	ryoj
噓	rypm
嘴	rypb
噳	rypk
嘑	rypd
喍	rypd
唬	rypu
噱	rypo
嘘	rypc
嚧	rypt
嚌	ryx
𠯿	ryc
嘀	rycb
咬	ryck
呫	ryr
嗃	ryrb
哼	ryrn
啍	ryrd
喨	ryru
㗒	ryrv
嚷	ryrv
嚎	ryro
啅	ryaj
噷	ryao
吭	ryhn
𠲖	ryhv
嚬	ryhc
喭	ryhh
㕸	ryt
嚱	ryti
噇	rytg
唼	rytv
噫	rytp
喑	ryta
吙	rf
咣	rfmu
哨	rfb
𠸑	rfbn
嘡	rfbg
噹	rfbw
嗩	rfbc
嚐	rfba
𡃇	rfkt
咪	rfd
𠺫	rfdj
噒	rfdq
啳	rfqu
啖	rff
嘮	rffs
𠻘	rfog
吵	rfh
巳	ru
𠮿	ru
嗤	rumi
喘	rumb
啱	rumr
嘣	rubb
鄳	runl
𨚼	rukb
咄	ruu
饕	ruoiv
㖗	ruon
嗺	ruog
𢁅	ruhjj
𠸉	ruhr
巽	rutc
𠯆	rv
巺	rvmc
吆	rvi
嘰	rvii
嚛	rvid
呦	rvis
𠯻	rvis
拟	rvio
吳	rvnk
喙	rvno
呉	rvnc
吖	rvl
叫	rvl
呶	rve
𠸎	rveq
𠵈	rvjd
𠵎	rvjr
喲	rvfi
𠺶	rvfb
𡃈	rvfj
噝	rvff
𠾼	rvfu
𠴕	rvfh
嗈	rvvu
民	rvp
𠹷	rvhi
𠰋	rom
噏	romm
喻	romn
唋	romd
啣	roml
𠵴	roml
嗱	romq
喩	romv
噞	romo
哈	romr
啥	romr
噲	roma
啽	romt
呤	roii
吟	roin
𠼮	roif
喰	roiv
𠹸	roiv
唸	roip
𠰺	roip
嗿	roic
嗆	roir
唅	roir
吶	rob
呐	rob
𤰉	robq
吃	ron
喉	ronk
𠺪	rond
唯	rog
㗱	rogd
噍	rogf
呚	rok
咻	rod
咐	rodi
吤	roll
嗰	rowr
咋	ros
咿	rosk
𠳔	ross
吘	roj
哖	roq
噙	royb
𠵱	royv
焁	rof
𠼭	roum
嚹	roud
𠹹	roob
唑	roog
吪	rop
噏	rorm
啽	rort
𠿬	rohe
喺	rohf
嘸	rotf
𡂈	roto
叱	rp
吣	rp
𠮟	rp
呁	rpmm
䪸	rpmbc
呁	rpim
吔	rpd
蟁	rplii
刡	rpln
㥸	rpwp
吨	rpu
哅	rpuk
噸	rpuc
敃	rpok
啕	rpou
吡	rpp
喈	rppa
呴	rpr
咆	rpru
昬	rpa
咰	rpa
咇	rph
唿	rphp
蕌	rphp
鴖	rphaf
吻	rphh
呭	rpt
喋	rptd
黽	rxu
只	rc
唫	rc
叭	rc
嘦	rcmwv
𠯋	rcms
嗡	rcim
鄖	rcnl
嗲	rckn
勛	rcks
吖	rcl
噌	rcwa
吩	rcsh
𡅈	rcyq
唂	rcor
𡃶	rcah
鶰	rchaf
𡆇	rcte
吅	rr
吕	rr
嚴	rrmmk
咢	rrmms
呺	rrms
咢	rrmjs
嚻	rrmcr
囂	rrmcr
𡀔	rrmr
噐	rrmr
噐	rrmrr
哭	rrik
獸	rrik
器	rrikr
喌	rrill
斝	rrbyj
郘	rrnl
鼉	rrwmu
單	rrwj
哵	rrsn
嚚	rrslr
駡	rrsqf
㗇	rrye
哫	rryo
喣	rrf
噀	rruc
嘂	rrvlr
呡	rrvp
品	rrr
噪	rrrd
喿	rrrd
㗁	rrrs
嘽	rrrj
喦	rrru
嵒	rrru
㗊	rrrr
碞	rrrr
𠻝	rrrh
唈	rrau
咒	rrhn
呪	rrhu
鷺	rrhaf
呾	ram
哻	ramj
啺	ramh
唧	rail
嘅	raiu
㘚	rank
嚪	ranx
𠻻	ranh
𠼦	rawe
嘬	rase
𠹵	rajv
敯	raye
𠾶	rayf
喅	rayt
吧	rau
邑	rau
哏	rav
喝	rapv
唱	raa
嚗	rate
听	rhml
噬	rhmo
𠺌	rhi
吆	rhi
𠶜	rhbn
噢	rhbk
咱	rhbu
响	rhbr
哚	rhnd
𠼝	rhnd
吺	rhne
呈	rhg
𠲍	rhgi
哠	rhgr
㕭	rhk
嘺	rhkb
㖭	rhkp
咊	rhd
唎	rhdn
噃	rhdw
唀	rhds
啾	rhdf
唩	rhdv
𡀝	rhdp
啝	rhdr
囖	rhwg
啤	rhwj
咚	rhey
咯	rher
咋	rhs
噭	rhsk
唳	rhsk
吀	rhj
唾	rhjm
喠	rhjg
咮	rhjd
喢	rhjx
咶	rhjr
吽	rhq
哦	rhqi
㕰	rhqu
呹	rhqo
嗁	rhyu
𠿫	rhfb
呼	rhfd
兄	rhu
嗅	rhuk
嚊	rhul
嘷	rhuj
囋	rhuc
呱	rhvo
𠷈	rhoq
嘥	rhoo
㗳	rhor
喒	rhoa
吒	rhp
呧	rhpm
喞	rhpl
嘅	rhpu
嗖	rhxe
唲	rhxu
嚠	rhcn
呂	rhr
𠵯	rhrn
嗚	rhrf
㕷	rha
啲	rhai
喤	rhag
嘄	rhad
㘉	rhal
嗥	rhaj
噑	rhaj
鳴	rhaf
唣	rhap
㗛	rhhk
䊵	rhhe
嚟	rhhe
啤	rhhj
哌	rhhv
呏	rht
咁	rtm
嘩	rtmj
啿	rtmv
唭	rtmc
𡁏	rtbo
唺	rtbc
囌	rtnd
嚉	rtgi
囈	rtgi
𠸍	rtgk
㗝	rtgf
唴	rtgu
咲	rtk
哎	rtk
喏	rtkr
𠸏	rtkr
𠸄	rtlk
嚥	rtlf
嘆	rtlo
喵	rtw
噂	rtwi
囆	rtwi
噧	rtwb
噥	rtwv
嘈	rtwa
𠯢	rtj
嚡	rtjg
嘞	rtjs
㗾	rtjp
咩	rtq
嗟	rtqm
嚆	rtyb
𡂴	rtyj
嗍	rtub
嗞	rtvi
𠸖	rtoi
嗏	rtod
嚄	rtoe
嚿	rtox
嗒	rtor
嗬	rtor
嗛	rtxc
哄	rtc
𠼻	rtcg
嘶	rtcl
噗	rtco
嗌	rtct
嚾	rtrg
唶	rta
嗼	rtak
囒	rtaw
噶	rtav
𠾭	rthv
日	a
曰	a
旦	am
晸	ammk
晨	ammv
曬	ammp
晤	ammr
戥	ami
晊	amig
𣌟	ambm
曇	ambi
曧	ambi
曘	ambb
曤	ambg
𣌊	ambe
𧡰	ambuu
暊	ambc
旺	amg
昊	amk
昮	amks
旴	amd
𣆳	amlk
量	amwg
曋	amwj
昻	amsl
昜	amsh
旱	amj
旰	amj
昰	amym
是	amyo
昃	amo
昞	amob
昺	amob
晒	amcw
鼂	amru
鼂	amrxu
晅	amam
毾	amhqu
鴠	amhaf
曞	amtb
𣇈	aimu
既	aimvu
昹	aine
㬙	aikf
即	aisl
䳭	aislf
晡	aijb
晙	aice
㫰	aiav
晟	aihs
晠	aihs
昪	ait
曠	aitc
冐	ab
明	ab
琞	abmgi
暖	abme
勗	abms
晍	abmr
猒	abik
曖	abbe
𣊬	abbq
盟	abbt
晭	abgr
暉	abjj
暈	abjj
曌	abjcm
冒	abu
晛	abuu
暩	abof
暚	abou
暝	abac
鷳	abhaf
昷	abt
門	an
閂	anm
閆	anmmm
閅	anmn
閜	anmnr
閏	anmg
閠	anmgi
閸	anmlm
闉	anmwg
闄	anmwv
閈	anmj
闞	anmjk
閇	anmy
閛	anmfj
閕	anmvh
閪	anmcw
開	anmt
闘	anmti
𨶙	anibp
閾	anirm
閬	aniav
閞	anit
閒	anb
閿	anbbe
闃	anbuk
闅	anbue
覵	anbuu
闝	anbck
閮	annkg
闋	annok
閻	annhx
闔	angit
閨	angg
閎	anki
𨳊	ankn
閹	anklu
閑	and
闈	andmq
闌	andwf
閉	andh
閩	anlmi
闠	anlmc
閫	anwd
閘	anwl
闤	anwlv
閖	ane
閯	anefh
闊	anehr
聞	ansj
闖	ansqf
闢	ansrj
闐	anjbc
闍	anjka
閳	anjwj
䦡	anjrr
闚	anqou
誾	anymr
闥	anygq
閔	anyk
閙	anylb
閼	anysy
閗	anyj
閡	anyvo
閌	anyhn
閍	anyhs
閚	anyt
闇	anyta
焛	anf
𨳒	anf
闛	anfbg
闣	anfbw
闂	anfqu
闓	anumt
𣈳	anus
闗	anvif
關	anvit
𨶹	anvff
閃	ano
欥	ano
闟	anomn
𨴴	anomc
閤	anomr
閥	anoi
閵	anog
暌	anok
閦	anooo
闟	anorm
悶	anp
𨳍	anp
閟	anph
曕	ancr
閱	ancru
閲	ancru
問	anr
闡	anrrj
闆	anrrr
閭	anrhr
間	ana
闁	anan
闒	anasm
閺	anayk
晚	anau
晩	anau
冕	anau
閶	anaa
閁	anh
昅	anhe
閣	anher
閐	anhqu
闑	anhud
閽	anhpa
閰	anhx
䦧	anhxu
𨉖	anhxh
関	antk
闕	antuo
閧	antc
闀	antcu
圼	ag
曀	agbt
晆	agg
曉	aggu
時	agdi
暿	agrr
旲	ak
晇	akms
旯	akn
晞	akkb
昦	akll
晻	aklu
暸	akcf
杲	ad
暐	admq
时	adi
時	adi
晽	add
暕	adwf
昩	adj
晰	adhl
鷴	adhaf
曱	al
晀	almo
晁	almo
映	albk
𣋡	albo
曊	alnc
堲	alg
昲	alln
曼	awle
曎	awlj
曙	awla
鄤	aenl
㿺	aedhe
曜	asmg
𣇉	askr
曯	asei
昛	ass
最	asje
朂	asjs
煚	asf
昵	asp
旫	ash
昭	ashr
暱	astr
早	aj
旪	aj
暄	ajmm
晥	ajmu
暷	ajii
昁	ajb
㫲	ajbd
暔	ajbj
晼	ajnu
暏	ajka
暑	ajka
昧	ajd
晏	ajv
暁	ajtu
晴	aqmb
暙	aqka
暳	aqjm
暳	aqjs
晣	aqhl
曨	aybp
旻	ayk
旼	ayk
暾	aydk
曃	ayle
暆	aysd
暶	ayso
𣉢	ayfd
昡	ayvi
𣆂	ayvi
晐	ayvo
晬	ayoj
曥	aypt
𣋠	ayx
昗	ayc
晈	ayck
暠	ayrb
景	ayrf
晾	ayrf
曩	ayrv
晫	ayaj
昉	ayhs
昘	ayhs
昱	ayt
曈	aytg
暲	aytj
暗	ayta
炅	af
╞	af
炚	af
𣉖	afmm
顯	afmbc
顥	afmbc
晃	afmu
晄	afmu
曭	afbf
歞	afno
暽	afdq
㫠	afq
晱	aff
影	afhhh
巴	au
旵	au
暟	aumt
郿	aunl
鱀	aunwf
塈	aug
勖	auks
槩	aud
㫞	aue
岊	auu
𣅽	auu
昢	auu
暨	auam
毷	auhqu
鶥	auhaf
妟	av
艮	av
𣊉	avii
㬎	avif
歇	avno
垦	avg
恳	avp
曏	avhl
毼	avhqu
鷃	avha
鷃	avhaf
鶡	avhaf
鷐	avhaf
㫻	aomb
題	aombc
𣈥	aomn
𣈯	aomn
昤	aoii
昑	aoin
晗	aoir
韙	aodmq
晦	aowy
昨	aos
旿	aoj
尟	aofh
匙	aop
鶗	aohaf
昣	aohh
暅	apmm
旳	api
昀	apim
旽	apu
曷	apvo
昆	app
昫	apr
晓	aphu
鵾	aphaf
易	aphh
昒	aphh
顕	acmbc
暡	acim
晜	acnh
昐	acsh
╠	ar
冔	armd
暇	arse
照	arf
煦	arf
曮	arrk
暺	arrj
昌	aa
昍	aa
𤦉	aamg
暘	aamh
暥	aajv
龧	aaja
暻	aayf
焸	aaf
暍	aapv
晹	aaph
晶	aaa
晿	aaa
曐	aaam
曡	aaam
曟	aaav
𣊫	aaaa
𣊭	aaaa
曑	aaah
暒	aahm
𣈲	aahu
鷼	aahaf
𪂇	aahaf
曝	aate
╟	ah
昕	ahml
眉	ahbu
晌	ahbr
晑	ahbr
曛	ahgf
晧	ahgr
剔	ahln
昄	ahe
昸	ahey
昈	ahs
曒	ahsk
星	ahqm
昳	ahqo
敡	ahye
𤋁	ahf
𣊊	ahum
曍	ahuj
昂	ahvl
暀	ahog
敭	ahok
暰	ahoo
晷	ahor
惖	ahp
晲	ahxu
暤	ahaj
暭	ahaj
𥟟	ahhd
昴	ahhl
昇	aht
曄	atmj
曅	atmj
曚	atbo
晪	atbc
𣋒	atnk
㬢	atgi
曦	atgs
𣌀	atgs
暪	atlb
暎	atlk
曣	atlf
暵	atlo
𣈴	atw
𣇷	atys
晎	atc
曗	atcd
暴	atce
謈	atcr
曔	atrk
𣈏	ata
暯	atak
竹	h
丿	h
⺮	h
𠂆	h
笁	hm
竺	hmm
䈣	hmmk
笎	hmmu
甀	hmmvn
籭	hmmp
籗	hmbg
籱	hmbg
眚	hmbu
篢	hmbc
虂	hmbr
築	hmnd
郵	hmnl
邸	hmnl
筇	hmnl
篫	hmnq
笴	hmnr
箌	hmgn
籈	hmgn
筭	hmgt
竽	hmd
斤	hml
𥮳	hmlm
筻	hmlk
甥	hmwks
篥	hmwd
簟	hmwj
篻	hmwf
歸	hmsmb
笻	hmsl
筇	hmsl
卮	hmsu
竿	hmj
筓	hmjj
斥	hmy
篶	hmyf
籋	hmfb
簪	hmua
笌	hmvh
筮	hmoo
惩	hmp
憇	hmp
后	hmr
垕	hmrg
皩	hmafu
巵	hmau
㽓	hmhmm
斵	hmhml
筑	hmhn
毁	hmhne
甡	hmhqm
鷎	hmha
鷎	hmhaf
鴟	hmhaf
笄	hmt
么	hi
魎	himlb
魒	himwf
魉	himob
箋	hii
魃	hiikk
魆	hiiv
𩲭	hiipj
魊	hiirm
篸	hiih
𥵃	hiit
簠	hibt
魍	hibtv
乏	hino
魓	hiwtj
庐	his
𥮉	hijb
魅	hijd
鬾	hije
魁	hiyj
魑	hiyub
魖	hiypm
魈	hifb
魕	hivii
魋	hiog
魀	hioll
𥳁	hipm
簏	hixp
啔	hir
笞	hir
筤	hiav
鬿	hihml
筬	hihs
犩	hihq
箴	hihr
鵝	hihaf
鵞	hihaf
鬽	hihhh
笲	hit
魌	hitmc
𥱊	hitb
𩴾	hitwi
䉀	hitf
魐	hitxc
簾	hitc
笡	hbm
顅	hbmbc
璺	hbmgi
筯	hbms
甂	hbmvn
釁	hbmch
筒	hbmr
礐	hbmr
舋	hbbm
覺	hbbuu
䈑	hbbr
䀉	hbbt
觷	hbnbg
學	hbnd
鄅	hbnl
鱟	hbnwf
壆	hbg
奥	hbk
奧	hbk
勪	hbks
筋	hbks
爨	hbddf
𦦵	hbdci
𠤣	hblmp
制	hbln
澩	hbe
䎗	hbsmm
翩	hbsmm
箏	hbsd
箙	hbse
騗	hbsqf
甪	hbq
舟	hbyi
燢	hbf
爂	hbf
籐	hbfe
籘	hbff
𥸎	hbff
自	hbu
嶨	hbu
篡	hbui
簒	hbui
籰	hbue
𥴠	hbue
纂	hbuf
筧	hbuu
篹	hbuu
籑	hbuv
筫	hbuc
篎	hbuh
算	hbut
雤	hbog
敿	hbok
箆	hbop
向	hbr
𠿟	hbr
嚳	hbhgr
緜	hbhvf
鷮	hbha
鷮	hbhaf
鶣	hbhaf
鷽	hbhaf
鵳	hbhaf
笧	hbt
血	hbt
黌	hbtlc
⺇	hn
⺈	hn
几	hn
𠂊	hn
凢	hn
篛	hnmm
凨	hnmmi
頽	hnmbc
夙	hnmni
颲	hnmnn
飋	hnmgh
風	hnmli
飃	hnmwf
颬	hnmvh
凬	hnma
鳳	hnmaf
凡	hni
筩	hnib
飇	hnikk
颱	hnir
颶	hnbmc
𩗗	hnbuc
䬙	hnbou
风	hnk
𠘰	hnk
筵	hnkm
筳	hnkg
飉	hnkcf
朵	hnd
梨	hnd
颹	hndmq
箛	hndo
篨	hnld
𥱥	hnld
第	hnlh
颸	hnwp
凤	hne
殳	hne
颾	hneii
篜	hnef
飂	hnsmh
䫿	hnshr
掣	hnq
𩗴	hnqkq
讆	hnymr
𩖰	hnyk
颭	hnyr
製	hnyhv
颵	hnfb
颷	hnff
飈	hnfff
𩖞	hnu
颴	hnono
㴝	hnoe
簦	hnot
悡	hnp
愆	hnp
颮	hnpru
鋫	hnc
簷	hncr
𩖸	hnrms
躗	hnryo
颺	hnamh
飍	hnhnn
䬐	hnhdv
風	hnhli
笈	hnhe
颳	hnhjr
犁	hnhq
颼	hnhxe
凰	hnhag
鳯	hnhaf
飀	hnhhw
颩	hnhhh
⺧	hg
壬	hg
𡈼	hg
顧	hgmbc
𤭮	hgmvn
丟	hgi
丢	hgi
籖	hgim
篕	hgit
籌	hgni
𨛘	hgnl
筀	hgg
動	hgks
等	hgdi
濌	hgea
熏	hgf
皝	hgfmu
筠	hgpm
簭	hgcr
告	hgr
籉	hgrg
靠	hgrly
毀	hghne
先	hghu
夭	hk
鄓	hknl
笅	hkk
棨	hkd
蚕	hklmi
刋	hkln
乔	hkll
肇	hklq
叐	hke
竻	hks
笳	hksr
譥	hkymr
岙	hku
嶴	hku
綮	hkvif
筴	hkoo
忝	hkp
懲	hkp
簝	hkcf
吞	hkr
呑	hkr
啓	hkr
喬	hkrbr
昋	hka
𦤦	hkapv
鴁	hkhaf
鸄	hkhaf
鴌	hkhaf
禾	hd
笨	hdm
秐	hdmmi
穲	hdmmp
秷	hdmig
穤	hdmbb
稬	hdmbk
稏	hdmlm
稉	hdmlk
秆	hdmj
秳	hdmjr
𥯤	hdmq
秠	hdmfm
穪	hdmfb
秤	hdmfj
甈	hdmvn
稫	hdmrw
私	hdi
穇	hdiih
秡	hdikk
𥡲	hdilb
穅	hdile
秿	hdijb
𥟇	hdije
秫	hdijc
嵇	hdiuu
稽	hdiua
穮	hdipf
稄	hdice
秮	hdir
稢	hdirm
稂	hdiav
𥝲	hdihu
穬	hditc
策	hdb
租	hdbm
穩	hdbmp
秱	hdbmr
稝	hdbb
箣	hdbn
稃	hdbnd
稱	hdbgb
稠	hdbgr
𥰡	hdbk
稲	hdbla
穱	hdbwi
穏	hdbsp
箱	hdbu
穄	hdbof
稻	hdbhx
盉	hdbt
臲	hdnmu
移	hdnin
季	hdnd
秄	hdnd
邾	hdnl
鄡	hdnl
穭	hdnwa
称	hdnf
稰	hdnob
龝	hdnxu
秀	hdnhs
穘	hdggu
秲	hdgdi
穡	hdgow
稑	hdgcg
稜	hdgce
秸	hdgr
穯	hdgrw
秇	hdkni
稀	hdkkb
箖	hdd
稦	hddmq
秣	hddj
秛	hddhe
秉	hdl
种	hdl
秧	hdlbk
利	hdln
剁	hdln
釉	hdlw
秞	hdlw
簌	hdlo
乘	hdlp
秭	hdlxh
籟	hdlc
番	hdw
稩	hdwb
秵	hdwk
稇	hdwd
稞	hdwd
釋	hdwlj
稒	hdwjr
稷	hdwce
稛	hdwhd
穓	hdwtc
穋	hdsmh
篐	hdsb
穉	hdseq
秬	hdss
𥡗	hdsqf
稺	hdsyj
𥣡	hdsyq
穉	hdsyq
秜	hdsp
𥟡	hdjmf
稼	hdjmo
穦	hdjmc
穗	hdjip
稙	hdjbm
稹	hdjbc
穂	hdjwp
秓	hdje
穃	hdjcr
秙	hdjr
秺	hdjhp
積	hdqmc
穢	hdymh
斅	hdye
科	hdyj
稸	hdyvw
穧	hdyx
秥	hdyr
稿	hdyrb
稕	hdyrd
穰	hdyrv
秔	hdyhn
穜	hdytg
穟	hdyto
稖	hdytr
䅧	hdyta
秋	hdf
稍	hdfb
秚	hdfq
鍫	hdfc
秒	hdfh
秈	hdu
稯	hduce
委	hdv
穖	hdvii
秢	hdomi
稐	hdomb
秹	hdomg
稌	hdomd
秴	hdomr
秢	hdoii
稔	hdoip
䅮	hdoir
䄲	hdob
稚	hdog
穛	hdogf
斆	hdok
黍	hdoe
箂	hdoo
稪	hdoae
悉	hdp
秕	hdpp
稭	hdppa
𥟠	hdppa
秘	hdph
𥯆	hdci
稊	hdcnh
秎	hdcsh
稅	hdcru
税	hdcru
和	hdr
鼄	hdrxu
程	hdrhg
稆	hdrhr
香	hda
稈	hdamj
穊	hdaiu
䅼	hdawe
秃	hdhn
毇	hdhne
秗	hdhk
穚	hdhkb
秝	hdhd
籕	hdhw
稗	hdhwj
秨	hdhs
稨	hdhsb
秊	hdhj
種	hdhjg
秏	hdhqu
秩	hdhqo
禿	hdhu
穳	hdhuc
秖	hdhvp
秅	hdhp
秪	hdhpm
穥	hdhxc
鷍	hdha
鷍	hdhaf
鴸	hdhaf
穆	hdhah
稗	hdhhj
乗	hdt
䅿	hdtmj
稘	hdtmc
穔	hdtlc
穠	hdtwv
穁	hdtsj
穫	hdtoe
𥣈	hdtcd
䅬	hdtct
稓	hdta
禦	hlmmf
頎	hlmbc
鼾	hlmj
齀	hlmvn
筄	hlmo
簣	hlmc
禹	hlbi
質	hlbuc
邤	hlnl
欣	hlno
䶑	hlgbo
鼽	hlkn
劤	hlks
齄	hldam
劓	hlln
笰	hlln
簘	hlll
齂	hlle
簰	hllj
簍	hllv
笛	hlw
斶	hlwli
簍	hlwv
齉	hljbv
筆	hlq
齇	hlypm
籔	hlvk
簶	hlve
齆	hlvvu
爪	hlo
齁	hlpr
簫	hlx
笫	hlxh
齃	hlapv
斦	hlhml
𥡝	hlhdl
齅	hlhuk
齈	hltwv
箅	hwml
粤	hwmvs
粵	hwmvs
簂	hwim
囱	hwni
囱	hwnk
鄱	hwnl
飜	hwnoo
睾	hwgtj
囟	hwk
筃	hwk
囪	hwkk
勫	hwks
笚	hwl
篾	hwli
簚	hwlb
籮	hwlg
簤	hwlc
䉪	hwww
笝	hwe
翻	hwsmm
箇	hwjr
恖	hwp
悤	hwp
𥯨	hwp
箘	hwhd
卑	hwhj
𠒇	hwhu
鶹	hwha
鶹	hwhaf
鷭	hwhaf
篳	hwtj
反	he
夂	he
夊	he
磐	hemr
簿	heii
箈	heir
盤	hebt
鄋	henl
垼	heg
务	heks
条	hed
槃	hed
螌	helmi
幋	helb
备	hew
笵	hesu
夅	heq
搫	heq
夆	heqj
冬	hey
处	hey
黐	heyub
黏	heyr
褩	heyhv
夈	hefd
媻	hev
縏	hevif
处	heo
慇	hep
筂	hepd
鎜	hec
各	her
洜	here
篞	heag
簜	heah
籓	hehw
灥	hehee
箲	hehu
箔	heha
鞶	hetlj
篊	hetc
戶	hs
乍	hs
勹	hs
箒	hsmb
𥤃	hsmbl
頺	hsmbc
筐	hsmg
籊	hsmg
笥	hsmr
籃	hsmt
戾	hsik
籃	hsit
肩	hsb
扃	hsbr
扁	hsbt
戹	hsn
扅	hsnin
戻	hsk
笋	hsk
筍	hsk
篋	hsko
䇹	hskr
扉	hslmy
篚	hsly
籄	hslc
扇	hssmm
䇯	hsj
箃	hsje
篤	hsqf
戽	hsyj
𡷊	hsyu
扂	hsyr
房	hsyhs
扆	hsyhv
勲	hsf
勳	hsf
𥳀	hsfi
扊	hsff
雇	hsog
敫	hsok
憅	hsp
怎	hsp
启	hsr
笸	hsr
戺	hsru
扈	hsrau
所	hshml
鳬	hshn
殷	hshne
𣪧	hshne
簈	hshj
𠒎	hshu
笤	hshr
鳸	hshaf
𩿞	hshaf
箳	hstt
千	hj
箮	hjmm
顊	hjmbc
簆	hjmk
筦	hjmu
籖	hjim
篿	hjii
簙	hjii
盾	hjbu
貭	hjbc
郫	hjnl
箢	hjnu
圱	hjg
䇭	hjkp
箸	hjka
朱	hjd
筞	hjd
栞	hjd
𠜱	hjln
刋	hjln
埀	hjlg
箑	hjlo
乖	hjlp
重	hjwg
翱	hjsmm
翶	hjsmm
翺	hjsmm
簳	hjjj
範	hjju
簐	hjjo
簵	hjjr
忎	hjp
箜	hjcm
舌	hjr
管	hjrr
幷	hjhmj
段	hjhne
甁	hjhjn
臿	hjhx
鵯	hjhaf
垂	hjtm
牛	hq
牜	hq
生	hqm
牾	hqmmr
箐	hqmb
拜	hqmqj
牼	hqmvm
簀	hqmc
牺	hqmcw
犡	hqmtb
我	hqi
犙	hqiih
犏	hqisb
牻	hqiuh
犥	hqipf
犋	hqbmc
𤘪	hqby
看	hqbu
犑	hqbuk
犅	hqbtu
觕	hqnbg
犍	hqnkq
牡	hqg
特	hqgdi
犢	hqgwc
犄	hqkmr
筹	hqki
牞	hqks
籍	hqda
牰	hqlw
牬	hqlxh
犤	hqwlp
籜	hqwj
牳	hqwyi
牭	hqwc
箍	hqsb
牣	hqshi
篲	hqjm
𤚗	hqjmm
犆	hqjbm
㹀	hqjbd
牸	hqjnd
犗	hqjqr
牯	hqjr
𤙥	hqjru
𤜆	hqybp
牤	hqyv
犒	hqyrb
犉	hqyrd
𤙴	hqyaj
牨	hqyhn
牥	hqyhs
犝	hqytg
犃	hqytr
犈	hqfqu
毛	hqu
犣	hqvvv
失	hqo
牷	hqomg
犔	hqond
牧	hqok
簮	hqoa
牝	hqp
牠	hqpd
犓	hqpuu
物	hqphh
吿	hqr
筘	hqr
𤘘	hqr
犌	hqrse
𤛔	hqawe
筢	hqau
犦	hqate
牿	hqhgr
犞	hqhkb
犐	hqhdj
籀	hqhw
篺	hqhj
牪	hqhq
牲	hqhqm
犇	hqhqq
牦	hqhqu
牴	hqhpm
箝	hqtm
簼	hqtb
犧	hqtgs
犪	hqtce
簎	hqta
犕	hqthb
舡	hym
舸	hymnr
𦩒	hymlm
篴	hymo
舾	hymcw
艔	hyite
𦨴	hybmr
簻	hybb
𥰆	hybb
艀	hybnd
籬	hybg
篣	hybs
䚀	hybuu
籠	hybp
艇	hynkg
艋	hyndt
郍	hynl
艪	hynwa
籯	hync
艬	hynri
艢	hygow
舿	hykms
舦	hyki
艜	hykpb
𦩑	hydoo
㿭	hydhe
𦨭	hydhe
舯	hyl
䇛	hylm
螽	hylii
艛	hyllv
舳	hylw
舺	hywl
簑	hywv
𥰁	hysm
艦	hysmt
艦	hysit
簇	hysk
箷	hysd
箊	hysy
舠	hysh
艉	hyshu
舵	hyjp
艕	hyybs
舷	hyyvi
籧	hyyo
艣	hyyps
艫	hyypt
艩	hyyx
航	hyyhn
舫	hyyhs
艟	hyytg
艄	hyfb
艡	hyfbw
舢	hyu
篱	hyub
艐	hyuce
笀	hyv
艅	hyomd
舲	hyoii
艌	hyoip
𦨮	hyoip
艙	hyoir
𦩂	hyono
艭	hyoge
舴	hyos
箤	hyoj
𥲤	hypm
虒	hypu
箎	hypu
舭	hypp
簴	hypc
籚	hypt
艓	hyptd
舩	hyci
筊	hyck
船	hycr
笘	hyr
篙	hyrb
籝	hyrn
龤	hyrn
篰	hyrl
艥	hyrji
籇	hyro
艒	hyabu
舥	hyau
簅	hyhm
笐	hyhn
䑺	hyhni
舤	hyhni
舧	hyhni
般	hyhne
艁	hyhgr
艞	hyhlo
舨	hyhe
艂	hyhej
舽	hyheq
籩	hyhs
舴	hyhs
艑	hyhsb
篷	hyhj
艘	hyhxe
簉	hyhr
舶	hyha
艊	hyhab
艎	hyhag
鵃	hyhaf
笠	hyt
𥴰	hytb
艨	hytbo
艤	hytgi
艚	hytwa
𥭴	hytj
艖	hytqm
篭	hytv
舼	hytc
艗	hytct
箁	hytr
艏	hythu
𪈳	hfmmp
鴚	hfmnr
甃	hfmvn
鵔	hfice
筲	hfb
箾	hfbn
簹	hfbw
鳦	hfn
鄔	hfnl
鄥	hfnl
歍	hfno
𪀔	hfgdi
鳨	hfks
勳	hfks
䲷	hfd
乎	hfd
釆	hfd
鴃	hfdk
蝵	hflmi
湬	hfe
𪆫	hfesd
鷌	hfsqf
鴕	hfjp
鴥	hfjc
揫	hfq
箞	hfqu
鷻	hfydk
簩	hffs
媝	hfv
鵦	hfvne
鵌	hfomd
鴏	hfoip
鵻	hfog
愁	hfp
鍫	hfc
鵿	hfaht
鸔	hfate
鳧	hfhn
鴤	hfhey
鷈	hfhyu
箵	hfhu
鶃	hfhxu
鶳	hfhrb
鶖	hfhaf
鶀	hftmc
鸃	hftgi
鸌	hftoe
臯	hummj
𠒑	hummu
頹	humbc
毢	humcw
兎	hui
鬼	hui
臭	huik
瞂	huikk
毧	huij
毬	huije
臯	huioj
毪	huihq
覒	hubuu
贊	hubuc
毽	hunkq
郳	hunl
𠒒	hunl
郋	hunl
氌	hunwa
歋	huno
墍	hug
𦤑	hukq
槩	hud
臬	hud
𦤎	hudm
毴	hulmy
穨	hulmc
𠜎	huln
鼻	huwml
毸	huwp
諬	huymr
氊	huywm
𣁽	huyj
毡	huyr
辠	huytj
毰	huytr
毜	huf
𤆬	huf
熈	huf
毩	hufd
毯	huff
嵆	huu
笜	huu
毺	huomn
毺	huomv
臮	huooo
憩	hup
息	hup
𣭚	hupru
毥	hupa
曁	huam
毨	huhgu
兟	huhgu
毳	huhuu
𠒣	huhon
鶞	huha
鶞	huhaf
鶂	huhaf
鷉	huhaf
鵚	huhaf
氆	hutca
氁	hutak
𧘇	hv
鼯	hvmmr
瓾	hvmvn
鼫	hvmr
鼣	hvik
鼥	hvikk
籪	hvil
系	hvif
瓜	hvio
笖	hvio
鼲	hvbjj
鼳	hvbuk
覛	hvbuu
覣	hvbuu
鼰	hvbuc
鼷	hvbvk
鼮	hvnkg
箓	hvne
篆	hvno
鼭	hvgdi
鼬	hvlw
笯	hve
鸟	hvsm
卬	hvsl
鼴	hvsav
鼦	hvshr
鼧	hvjp
鼵	hvjck
鼱	hvqmb
諐	hvymr
鼤	hvyk
焈	hvf
箹	hvfi
氏	hvp
鼩	hvpr
鼢	hvcsh
筎	hvr
鼹	hvajv
鼨	hvhey
鼪	hvhqm
鼶	hvhyu
兜	hvhu
魏	hvhui
䶉	hvhhw
鼸	hvtxc
八	ho
彳	ho
行	hommn
籥	homb
㣔	homn
鴴	homnf
筌	homg
箯	homk
筡	homd
徱	homwf
衎	homjn
征	homym
衏	homun
徑	homvm
簽	homo
徆	homcw
答	homr
衙	homrn
筏	hoi
籤	hoim
𧗠	hoimn
笭	hoii
籂	hoib
笒	hoin
徧	hoisb
笩	hoip
術	hoicn
𢓭	hoice
筨	hoir
篬	hoir
笍	hob
徂	hobm
篧	hobg
衢	hobgn
徟	hobgr
忂	hobug
徯	hobvk
徭	hobou
籲	hobc
衕	hobrn
篌	honk
衡	honkn
𧗽	honkn
𧗾	honkn
徤	honkq
𢖍	honfn
彶	honhe
坕	hog
街	hoggn
徺	hoggu
待	hogdi
䉶	hoge
徒	hogyo
𢔛	hogtj
笶	hok
徛	hokmr
劮	hoks
徫	hodmq
符	hodi
衞	hodbn
衛	hodqn
徠	hodoo
彼	hodhe
筗	hol
徘	holmy
瓥	holii
𠠬	holn
筱	holk
篠	hold
彿	holln
律	holq
𥮴	holy
徊	howr
衍	hoemn
径	hoeg
笮	hos
徲	hoseq
聳	hosj
徖	hojmf
徳	hojwp
德	hojwp
衠	hojcn
衚	hojrn
篟	hoqb
𢔓	hoqkq
衒	hoyin
徹	hoybk
徬	hoybs
徿	hoybp
䘕	hoynn
往	hoyg
徙	hoylo
徏	hoylh
斞	hoyj
㼎	hoyck
忀	hoyrv
彷	hoyhs
徸	hoytg
𢕔	hoytj
熧	hof
徶	hofbk
徜	hofbr
徴	hougk
徵	hougk
䘗	houfn
徽	houfk
黴	houfk
鰴	houfk
微	houuk
徾	hourk
後	hovie
衟	hovun
徐	hoomd
御	hooml
徻	hooma
彾	hooii
籢	hook
筰	hoos
衘	hoovn
從	hoooo
復	hooae
怣	hop
惥	hop
慫	hop
𢜛	hop
彴	hopi
瓝	hopi
彻	hopsh
爮	hopru
瓟	hopru
徇	hopa
銜	hocmn
彸	hoci
咎	hor
徦	horse
徎	horhg
昝	hoa
得	hoami
徥	hoamo
爬	hoau
忁	hoaue
很	hoav
𢔰	hoahu
役	hohne
衝	hohgn
𧗤	hohkn
筰	hohs
徧	hohsb
徼	hohsk
循	hohju
徃	hohqm
瓞	hohqo
𤔅	hohqo
彽	hohpm
徨	hohag
鴔	hohaf
鴩	hohaf
徉	hotq
従	hotyo
衜	hotun
衖	hotcn
乇	hp
氐	hpm
笉	hpmm
頿	hpmbc
顖	hpmbc
旣	hpmvu
𥫩	hpi
笉	hpim
鄎	hpnl
竾	hpd
筷	hpdk
帋	hplb
剩	hpln
印	hpsl
卽	hpsl
篘	hpuu
笓	hpp
笱	hpr
笣	hpru
昏	hpa
筍	hpa
鵖	hphaf
笏	hphh
笹	hpt
臼	hx
𦥑	hx
興	hxbc
盥	hxbt
歃	hxno
帠	hxlb
叟	hxle
舅	hxwks
輿	hxjc
舃	hxysf
舄	hxyf
與	hxyc
龜	hxu
鼠	hxvyv
臾	hxo
身	hxh
兒	hxhu
舁	hxt
礜	hcmr
籛	hcii
臖	hcb
酇	hcnl
鄮	hcnl
歟	hcno
𡒊	hcg
劉	hcln
劗	hcln
轝	hcjwj
擧	hcq
舉	hcq
譽	hcymr
嬃	hcv
籙	hcve
㦛	hcp
𥳾	hcpm
籦	hchg
鸒	hchaf
頟	hrmbc
頧	hrmbc
頶	hrmbc
師	hrmlb
簬	hrmr
篔	hrbc
郜	hrnl
郈	hrnl
舚	hrncr
垕	hrg
舑	hrgb
勂	hrks
𦧺	hrdlc
蛗	hrlmi
帥	hrlb
刮	hrln
劄	hrln
𨸏	hrlr
𦧲	hrwvf
箿	hrsj
阜	hrj
烏	hryf
辞	hrytj
舕	hrff
乱	hru
峊	hru
簨	hruc
笢	hrvp
雒	hrog
啟	hrok
敋	hrok
惒	hrp
簞	hrrj
舔	hrhkp
舐	hrhvp
筥	hrhr
鴰	hrha
鴰	hrhaf
鵠	hrhaf
鵅	hrhaf
鴭	hrhaf
甜	hrtm
白	ha
笪	ham
皐	hammj
𤿂	hambi
皇	hamg
筸	hamj
馢	haii
馛	haikk
節	hail
皐	haioj
皫	haipf
皗	habgr
皭	habwi
簢	hank
籣	hanw
簡	hana
䭲	hakmr
馣	haklu
皋	hakj
馡	halmy
帛	halb
畠	haw
𥲑	hawe
馧	hawot
泉	hae
灥	haehe
馜	hasp
皁	haj
皖	hajmu
馪	hajmc
馞	hajbd
𤾂	hajnu
𤽜	hajd
馩	hajtc
皘	haqmb
䭰	haqkq
皉	haymp
梟	hayd
鳥	hayf
島	hayu
裊	hayv
皎	hayck
皜	hayrb
笆	hau
癿	hau
皚	haumt
䭯	hauu
皪	havid
簋	havt
皊	haoii
馠	haoir
㿥	haobg
敀	haok
馥	haoae
皀	hap
皂	hap
的	hapi
箟	happ
馝	haph
馚	hacsh
皔	haamj
馤	haapv
皓	hahgr
皤	hahdw
皈	hahe
皦	hahsk
皒	hahqi
皃	hahu
魄	hahui
𩡗	hahuk
𤾚	hahud
皥	hahuj
𤾆	hahxu
皡	hahaj
皞	hahaj
皛	hahaa
馫	hahaa
皣	hatmj
𤾸	hatif
馦	hatxc
皏	hatt
𨉼	hhmmp
須	hhmbc
𨊛	hhmdm
躿	hhile
笟	hhio
躴	hhiav
睝	hhbu
貿	hhbuc
躬	hhn
凢	hhn
竼	hhni
鯬	hhnwf
躱	hhnsd
筅	hhgu
筶	hhgr
笑	hhk
躸	hhkmr
簥	hhkb
棃	hhd
躰	hhdm
射	hhdi
筣	hhdn
簃	hhdn
篍	hhdf
䠷	hhlmo
躭	hhlbu
軁	hhlwv
籞	hhlf
笊	hhlo
留	hhw
黧	hhwgf
躶	hhwd
箄	hhwj
篦	hhwp
笗	hhey
笮	hhs
躼	hhsmv
篇	hhsb
躯	hhsk
卯	hhsl
卵	hhsli
孵	hhsld
毈	hhsle
贕	hhslc
軀	hhsrr
躽	hhsav
剓	hhsh
箠	hhjm
軉	hhjmc
筈	hhjr
笙	hhqm
笔	hhqu
篪	hhyu
躺	hhfbr
軂	hhffs
𨈘	hhfh
籫	hhuc
篼	hhvu
笟	hhvo
筕	hhon
䉠	hhok
篽	hhol
黎	hhoe
簁	hhoo
惣	hhp
躹	hhpfd
𨈚	hhpp
籅	hhxc
錅	hhc
篩	hhrb
軃	hhrrj
躳	hhrhr
卿	hhail
篁	hhag
彡	hhh
躲	hhhnd
躷	hhhdv
箄	hhhj
犂	hhhq
辵	hhho
鵹	hhhaf
軆	hhtwt
升	ht
衃	htmf
篏	htmo
箕	htmc
箭	htbn
衄	htng
䘏	htnl
欰	htno
𡉼	htg
箬	htkr
剰	htln
簧	htlc
筁	htw
𣲛	hte
卹	htsl
衈	htsj
衂	htshi
簕	htjs
衅	htfq
衆	htoho
憩	htp
簊	htcg
簛	htcl
簸	htce
鷑	hthaf
衇	hthhv
篝	httb
衊	httwi
卝	t
廿	t
䒑	t
⺾	t
艹	t
甘	tm
芸	tmmi
芌	tmms
葝	tmms
甛	tmmjr
芫	tmmu
甚	tmmv
莀	tmmv
其	tmmc
荎	tmig
䖅	tmbm
蕓	tmbi
蕶	tmbi
薷	tmbb
藿	tmbg
䓴	tmbk
荋	tmbl
蕾	tmbw
虉	tmbf
覲	tmbuu
虂	tmbr
蘦	tmbr
艼	tmn
薤	tmnm
茢	tmnn
邯	tmnl
鄞	tmnl
茿	tmnj
𦶣	tmnf
蒆	tmnv
薞	tmnv
歏	tmno
苛	tmnr
薚	tmnh
菿	tmgn
薽	tmgn
蘸	tmgf
蘁	tmgr
勤	tmks
芜	tmku
某	tmd
芋	tmd
藶	tmdm
菫	tmlm
𦲸	tmlb
莄	tmlk
薑	tmwm
蕈	tmwj
蔈	tmwf
葽	tmwv
𧂯	tmwt
苊	tmsu
𦮖	tmjo
芐	tmy
𦭒	tmym
齹	tmymu
蔫	tmyf
芣	tmf
苤	tmfm
薾	tmfb
苹	tmfj
蒜	tmff
𦷜	tmue
莖	tmvm
蓐	tmvi
芽	tmvh
蕤	tmom
苪	tmob
莁	tmoo
藸	tmoa
塟	tmpg
葬	tmpt
茜	tmcw
莤	tmcw
虁	tmce
䕢	tmrm
蒚	tmrb
葍	tmrw
藞	tmrr
荳	tmrt
荁	tmam
藶	tmhm
斳	tmhml
蕥	tmhg
蒝	tmhf
茾	tmt
荊	tmtn
華	tmtj
蕨	tmto
蓤	time
藏	tims
茨	timo
菚	tii
蓢	tiib
蓈	tiil
蔘	tiih
𦾟	tiit
蒪	tibi
芝	tino
芆	tik
茇	tikk
蒍	tikf
𦬓	tiku
蓭	tikv
莽	tikt
蔴	tidd
藦	tidq
蘼	tidy
䕷	tidf
蘑	tidr
荘	tilg
菮	tilo
蓎	tilr
芦	tis
𦼦	tist
茙	tij
莆	tijb
莍	tije
蔴	tijc
䔃	tifm
薬	tiod
薋	tioc
懟	tip
芅	tip
蘪	tipd
藨	tipf
薦	tixf
蔍	tixp
𨮝	tic
荾	tice
苔	tir
葈	tird
莨	tiav
茂	tih
菧	tihm
荗	tihi
荿	tihs
葳	tihv
蕆	tihc
葴	tihr
蒧	tihr
鷀	tihaf
鷷	tihaf
蓆	titb
蔗	titf
薕	titc
苴	tbm
蒄	tbmi
顢	tbmb
顢	tbmbc
顜	tbmbc
莹	tbmg
蒏	tbmw
萲	tbme
莇	tbms
蒙	tbmo
茼	tbmr
黻	tbikk
黼	tbijb
萠	tbb
蓇	tbbb
薆	tbbe
蕣	tbbq
薍	tbbu
覯	tbbuu
萵	tbbr
翦	tbnm
蒬	tbni
莩	tbnd
煎	tbnf
剪	tbnh
塑	tbg
䓟	tbgr
䒽	tbkk
劳	tbks
勱	tbks
䔳	tbkf
荣	tbd
菜	tbd
槊	tbd
𦹮	tbdh
繭	tbli
萤	tbli
前	tbln
蒯	tbln
𦬣	tbe
菔	tbse
葷	tbjj
䒟	tby
斠	tbyj
藤	tbfe
蕂	tbfs
虅	tbff
苜	tbu
萈	tbui
藈	tbuk
蔝	tbud
薡	tbul
蘨	tbuf
莧	tbuu
萛	tbut
荽	tbv
萦	tbvf
散	tbok
葄	tbos
蔡	tbof
䔄	tbou
愬	tbp
𦽳	tbp
葋	tbpr
典	tbc
蓥	tbc
萴	tbcn
黺	tbcsh
蘡	tbcv
苘	tbr
萉	tbau
蓂	tbac
薶	tbhg
葄	tbhs
荦	tbhq
蔿	tbhf
藐	tbhu
蓞	tbhx
菵	tbtv
艺	tn
芎	tn
蒻	tnmm
顭	tnmbc
蔬	tnmu
芕	tni
苰	tni
蔃	tnii
芧	tnin
茤	tnin
荈	tniq
苑	tniu
蕵	tniv
茗	tnir
茅	tnih
藑	tnbe
蔛	tnbj
薢	tnbq
萯	tnbc
鄸	tnnl
蕷	tnnc
莚	tnkm
莛	tnkg
芓	tnd
蓀	tndf
芤	tndu
菰	tndo
䓝	tndt
蕯	tnlm
薩	tnlm
䕃	tnli
蔭	tnli
蒢	tnld
蔯	tnlw
䔖	tnle
𦶤	tnlu
蘟	tnlp
𦻕	tnlp
𦱆	tnlp
藬	tnlc
苐	tnlh
蒸	tnef
葞	tnsj
萾	tnst
𦵴	tnqd
𦱁	tnyi
薊	tnfn
蘇	tnfd
蘚	tnfq
葂	tnus
葾	tnup
芡	tno
葵	tnok
蕟	tnoe
𦴧	tnoo
薝	tncr
菟	tnai
莬	tnau
葇	tnhd
芨	tnhe
艿	tnhs
蓩	tnhs
萏	tnhx
虇	tntg
芏	tg
𦍌	tg
顴	tgmbc
𦱾	tgmj
羡	tgimo
藝	tgii
羕	tgine
爇	tgif
蓋	tgit
苒	tgb
觀	tgbuu
盖	tgbt
薵	tgni
酄	tgnl
歡	tgno
羑	tgno
莰	tgno
茥	tgg
葑	tggi
蓺	tggi
䕭	tggf
蕘	tggu
美	tgk
勸	tgks
對	tgdi
𧕴	tglmi
羛	tglln
藚	tgwc
羨	tgeno
𧅥	tgea
蔜	tgsk
蓻	tgji
蕔	tgje
𢺋	tgq
蘾	tgyv
𦹷	tgyr
羔	tgf
羮	tgfmo
羮	tgfo
羹	tgftk
𧄍	tgum
姜	tgv
臡	tgobo
薔	tgow
恙	tgp
戁	tgp
荺	tgpm
菱	tgce
䓀	tgr
薹	tgrg
䕒	tgrr
𣂷	tghml
𣂼	tghml
𦍑	tghi
羗	tghi
飌	tghni
羲	tghds
義	tghqi
羌	tghu
鸛	tghaf
薣	tgte
善	tgtr
艾	tk
荂	tkms
萘	tkmf
䓫	tkmr
葢	tkit
荑	tkn
艽	tkn
芄	tkni
䣐	tknl
鄭	tknl
鄚	tknl
莃	tkkb
檠	tkd
蟼	tklmi
茬	tklg
荐	tkld
菴	tklu
苃	tke
艻	tks
荔	tkss
驚	tksqf
苏	tksc
茄	tksr
莾	tkjt
擎	tkq
警	tkymr
蒺	tkok
莢	tkoo
憼	tkp
蔕	tkpb
蔱	tkce
若	tkr
蠚	tkri
惹	tkrp
藱	tkhi
莥	tkhg
获	tkhk
蕕	tkhw
荻	tkhf
𦸒	tkhr
鴱	tkha
鴱	tkhaf
鶧	tkhaf
𪅐	tkhaf
𪆴	tkhaf
苯	tdm
葦	tdmq
茦	tdb
蕀	tdbb
莿	tdbn
蓛	tdbk
葙	tdbu
鄴	tdnl
蓕	tdgg
芵	tdk
菻	tdd
蔌	tdlo
藾	tdlc
菄	tdw
萰	tdwf
藲	tdsr
茉	tdj
䓩	tdje
𧄧	tdqt
藮	tdof
萊	tdoo
菘	tdci
莕	tdr
𦹂	tdrd
𦶠	tdav
菥	tdhl
鸈	tdhaf
鷋	tdhaf
𧁒	tdte
𦬕	tl
韮	tlmm
茧	tlmi
菲	tlmy
苝	tlmp
蕢	tlmc
藎	tlmt
芇	tlb
英	tlbk
㒼	tlbo
萜	tlbr
𩤯	tlkf
𪃳	tlkf
蟴	tllmi
茀	tlln
蔞	tllv
苖	tlw
蔞	tlwv
黃	tlwc
黄	tlwc
革	tlj
茟	tlq
堇	tlqm
𦻔	tlyk
蕜	tlyp
藪	tlvk
㷼	tlpf
燕	tlpf
鷰	tlpf
嬊	tlpv
蕭	tlx
苗	tw
曲	tw
農	twmmv
葨	twmv
豊	twmrt
蔮	twim
猷	twik
𨠫	twiku
蠆	twbi
躉	twbo
𧄌	twbo
荲	twg
薗	twgv
奠	twk
茵	twk
莮	twks
蒽	twkp
菓	twd
尊	twdi
蔑	twli
薎	twli
蠤	twlii
萬	twlb
夢	twln
甍	twln
藅	twln
蘮	twln
蘿	twlg
蘉	twle
瞢	twlu
薨	twlp
藣	twlp
蕒	twlc
薯	twla
蘲	twwg
蘽	twwd
藟	twww
虆	twwf
苺	twyi
蔨	twfu
䕸	twfr
𦮗	twv
蔂	twvf
苬	two
蒕	twot
葸	twp
黄	twc
莔	twcb
茴	twr
曹	twa
菌	twhd
鶓	twhaf
蓽	twtj
茳	tem
𦭑	temn
萍	temj
藫	temj
薸	temf
菏	temr
薄	teii
蒲	teib
蒗	teiv
菭	teir
菹	tebm
𦷰	tebd
𦷪	tebv
莈	tene
茎	teg
蔆	tege
莯	ted
菠	tede
劐	teln
葏	telq
莐	telu
蕅	tewb
䕪	tewj
薀	tewt
蕖	tesd
蓡	tese
薓	tese
菃	tess
范	tesu
菬	tesr
蘫	test
蔳	teqb
薃	teyb
蔋	teye
蓅	teyu
茫	teyv
𦴢	teyp
𦹃	teyr
𦲷	teyt
糳	tefd
莎	tefh
薻	tevd
虃	teom
蕍	teon
蒤	teod
𦷫	teoy
蒞	teot
𦴥	tepa
鑿	tec
藻	terd
䕕	teae
䔽	teav
𦹲	teap
蕩	teah
蕰	teat
䓅	tehl
藩	tehw
蒎	tehv
𦿞	tehp
落	tehr
𦶡	tehr
萿	tehr
萡	teha
蘯	teht
葓	tetc
蓱	tett
蕁	tsmi
䒰	tsmg
藋	tsmg
䕜	tsmj
萇	tsmv
蓼	tsmh
藍	tsmt
蕼	tsiq
荵	tsip
藯	tsip
蕻	tsic
藍	tsit
芛	tsk
莙	tskr
茝	tsll
茞	tsll
菣	tsle
蘙	tsem
藂	tseo
藖	tsec
苣	tss
茸	tsj
蘗	tsjd
𦳃	tsjl
菆	tsje
蘵	tsja
𦰡	tsql
蔚	tsfi
芑	tsu
𦬨	tso
懃	tsp
苨	tsp
苉	tsc
薜	tsrj
蔒	tsrf
蓲	tsrr
芀	tsh
荱	tshu
苕	tshr
茘	tshh
卅	tj
萱	tjmm
靪	tjmn
苧	tjmn
荢	tjmd
韁	tjmwm
蔻	tjme
靬	tjmj
萗	tjmf
靰	tjmu
莞	tjmu
𦸅	tjmv
萣	tjmo
蔩	tjmc
薲	tjmc
𧅤	tjmc
菪	tjmr
蓴	tjii
蕙	tjip
韀	tjixf
芾	tjb
靻	tjbm
萓	tjbm
荸	tjbd
帯	tjblb
萳	tjbj
鞵	tjbvk
蒖	tjbc
鞱	tjbhx
鞃	tjni
鞬	tjnkq
茡	tjnd
孽	tjnd
靷	tjnl
鄿	tjnl
菀	tjnu
韂	tjncr
鞔	tjnau
鞣	tjnhd
靸	tjnhe
靯	tjg
鞋	tjgg
韇	tjgwc
鞊	tjgr
勒	tjks
荖	tjkp
著	tjka
苿	tjd
蘗	tjd
葧	tjds
靺	tjdj
鞁	tjdhe
鞉	tjlmo
鞅	tjlbk
荆	tjln
鞻	tjllv
鞻	tjlwv
萋	tjlv
萐	tjlo
鞇	tjwk
莗	tjwj
鞸	tjwtj
芰	tje
蘻	tjef
鞜	tjea
靱	tjsk
靭	tjshi
鞀	tjshr
蔪	tjjl
蓒	tjjj
鞍	tjjv
鞚	tjjcm
鞡	tjqyt
藼	tjqp
韆	tjymu
韃	tjygq
鞹	tjydl
鞟	tjyrd
鞛	tjytr
鞘	tjfb
鞩	tjfbn
鞺	tjfbg
鞝	tjfbr
靽	tjfq
荌	tjv
鞿	tjvii
靿	tjvis
鞭	tjomk
鞈	tjomr
靲	tjoin
靹	tjob
靴	tjop
鞥	tjort
蓿	tjoa
藌	tjpi
靮	tjpi
薴	tjpn
鞫	tjpyr
鞠	tjpfd
蔤	tjpu
鞄	tjpru
蓍	tjpa
靾	tjpt
鞢	tjptd
藭	tjcn
葖	tjck
蓉	tjcr
苦	tjr
葫	tjrb
鞙	tjrb
躠	tjryo
菅	tjrr
鞓	tjrhg
靼	tjam
鞮	tjamo
靶	tjau
鞎	tjav
韅	tjavf
鞨	tjapv
靳	tjhml
鞽	tjhkb
鞂	tjhd
鞦	tjhdf
鞞	tjhwj
藛	tjhf
𦴦	tjhr
鷨	tjhaf
鞾	tjtmj
韉	tjtif
韈	tjtwm
韈	tjtwi
藆	tjtq
韄	tjtoe
鞳	tjtor
蕡	tjtc
韊	tjtaw
鞴	tjthb
鞲	tjttb
羋	tq
⺶	tq
羊	tq
𦍋	tq
差	tqm
菁	tqmb
羺	tqmbb
羥	tqmvm
羱	tqmhf
蒱	tqib
菝	tqik
羢	tqij
羻	tqixe
羧	tqice
羬	tqihr
𧂮	tqbd
着	tqbu
羞	tqng
羠	tqkn
蓁	tqkd
菶	tqkq
萶	tqka
𦶮	tqdi
𧂭	tqdi
藕	tqdb
藉	tqda
䍮	tqlmo
菗	tqlw
蘀	tqwj
翔	tqsmm
𦎾	tqsyq
萔	tqsr
䒠	tqj
蔧	tqjm
羜	tqjmn
羦	tqjmu
蓵	tqjo
羵	tqjtc
荴	tqqo
羶	tqywm
譱	tqyrr
菈	tqyt
羙	tqf
莏	tqfh
羰	tqumf
芙	tqo
羭	tqomn
羷	tqomo
羚	tqoii
蓷	tqog
菢	tqpu
羒	tqcsh
𧂈	tqrd
羓	tqau
䔶	tqao
羯	tqapv
羖	tqhne
葜	tqhk
羳	tqhdw
羝	tqhpm
葀	tqhr
鴹	tqhaf
羏	tqhhh
羴	tqtqq
蕋	tymm
蘃	tymd
茮	tymf
蓫	tymo
茈	tymp
薉	tymh
𦱀	tyib
茺	tyiu
蒂	tybb
薖	tybb
蘺	tybg
蒡	tybs
𦾾	tybu
藃	tybo
蘢	tybp
蓪	tynb
薘	tygq
薳	tygv
芠	tyk
䔻	tydk
薪	tydl
藽	tydu
藗	tydo
芷	tylm
荹	tylh
蓾	tywi
蓑	tywv
薒	tyed
虀	tysm
蔟	tysk
葹	tysd
菸	tysy
蔙	tyso
𦴪	tysp
蓮	tyjj
苄	tyy
藡	tyyb
蘧	tyyo
蒾	tyfd
菽	tyfe
𡖂	tyue
䕫	tyue
芒	tyv
蕹	tyvg
蓄	tyvw
荒	tyvu
荄	tyvo
莣	tyvp
𦻗	tyog
藙	tyoe
萃	tyoj
蔖	typm
𧃍	type
䔝	typf
萀	typu
藘	typp
蘆	typt
薺	tyx
蔏	tycb
蔐	tycb
茭	tyck
𧅵	tycj
萒	tycu
蓘	tycv
蔉	tycv
𦶧	tycv
苫	tyr
蒿	tyrb
𧀎	tyrb
葶	tyrn
藁	tyrd
蔀	tyrl
蘐	tyre
𦻑	tyre
蕸	tyre
蔎	tyre
蘘	tyrv
藹	tyrv
薧	tyrp
藷	tyra
䓬	tyaj
苀	tyhn
菦	tyhl
芳	tyhs
蓬	tyhj
蘋	tyhc
苙	tyt
𦲂	tyti
𦵑	tyti
𦽴	tytb
蕫	tytg
莘	tytj
蔁	tytj
菨	tytv
薏	tytp
菩	tytr
蒟	tytr
萻	tyta
苂	tf
茪	tfmu
薠	tfmc
莦	tfb
萷	tfbn
蔽	tfbk
蕿	tfbe
酀	tfnl
𡙡	tfk
虌	tfku
蘱	tfkc
菤	tfqu
𦻐	tfyj
菼	tff
藀	tfff
䓎	tfpi
㬫	tfa
蔊	tfaj
羗	tui
馘	tuirm
朔	tub
菡	tune
欮	tuno
蘴	tujt
茁	tuu
药	tvmi
蔣	tvmi
薅	tvmi
莊	tvmg
葘	tvmw
蘠	tvmw
戡	tvi
兹	tvii
茲	tvii
甆	tvin
孶	tvid
藥	tvid
孳	tvid
苭	tvis
鶿	tvif
苡	tvio
慈	tvip
慈	tvip
蒵	tvbvk
夦	tvnin
菉	tvne
歁	tvno
蒃	tvno
勘	tvks
荍	tvlk
𦶦	tvsl
𦲁	tvsp
𦳀	tvjd
𦺋	tvje
𦹅	tvju
菇	tvjr
斟	tvyj
𦴣	tvyv
葒	tvfm
葤	tvfi
葯	tvfi
蒳	tvfb
虊	tvfd
藧	tvfe
蘕	tvfj
蔠	tvfy
蕬	tvff
蒓	tvfu
蕝	tvfu
䕑	tvfv
𧃒	tvfv
𧄉	tvfp
𦹄	tvfr
𦿟	tvfr
𦻖	tvfa
䔋	tvfh
尠	tvfh
蒶	tvfh
𦯷	tvfh
藴	tvft
蘊	tvft
𦾡	tvuk
菑	tvvw
葌	tvvv
茹	tvr
蒘	tvrq
蕠	tvrf
𦶥	tvhi
薌	tvhl
芢	tomm
菕	tomb
蘥	tomb
萮	tomn
芞	tomn
荃	tomg
荼	tomd
薟	tomo
荷	tomr
荅	tomr
薈	toma
葊	tomt
茷	toi
苓	toii
芩	toin
茯	toik
葰	toie
菍	toip
䕘	toic
莟	toir
蒼	toir
養	toiav
芮	tob
蒮	tobg
葔	tonk
鯗	tonwf
芿	tons
歎	tono
萑	tog
雈	tog
茌	tog
蕉	togf
舊	togx
薙	tokg
蘩	tokf
𧁋	tokp
茶	tod
茠	tod
苻	todi
茽	tol
蓨	tolb
莜	tolk
葔	tolk
蓧	told
芥	toll
蓚	tolh
莓	towy
苲	tos
葠	tose
𦴨	tosr
蒨	toqb
𦮳	toym
𦲤	toyv
蓓	toyr
𦴩	toyr
莅	toyt
苶	tof
苮	tou
蒛	touk
葅	toom
難	toog
莝	toog
蘞	took
蓌	tooe
莋	toos
蘝	tooo
花	top
芲	top
葆	tord
葊	tort
艱	toav
荏	tohg
莋	tohs
𦭛	tohj
氋	tohqu
鸏	tohaf
莅	toty
蕪	totf
𧁓	totv
芯	tp
蔔	tpmw
䔛	tpmc
芍	tpi
芶	tpi
葡	tpib
𦲀	tpir
薿	tpko
葱	tpkp
蘔	tpdc
蘹	tpyv
𦮝	tpyv
菊	tpfd
蘏	tpfc
芚	tpu
蒭	tpuu
萅	tpua
萄	tpou
芘	tpp
蘂	tppd
蕊	tppp
蒈	tppa
苟	tpr
茍	tpr
苞	tpru
荀	tpa
𦮂	tpa
苾	tph
䓤	tphp
芴	tphh
𦭓	tpt
葉	tptd
兼	txc
业	tc
共	tc
菳	tc
甉	tcmvn
碁	tcmr
蓊	tcim
朞	tcb
期	tcb
覥	tcbuu
益	tcbt
欺	tcno
歉	tcno
彂	tcnok
基	tcg
黊	tcgg
棊	tcd
蛬	tclmi
蜝	tclmi
黆	tclbu
酋	tcwm
棻	tcsd
芬	tcsh
葐	tcst
輂	tcjwj
拲	tcq
諅	tcymr
黈	tcyg
斢	tcyj
黇	tcyr
黹	tcfb
綦	tcvif
黅	tcoin
敟	tcok
恭	tcp
惎	tcp
巷	tcru
莌	tcru
普	tca
斯	tchml
夔	tche
鷬	tcha
鷬	tchaf
䳍	tchaf
鶼	tchaf
䳢	tchaf
業	tctd
叢	tcte
𦬅	tr
蕗	trmr
蒷	trbc
鄯	trnl
鄀	trnl
剳	trln
苢	trlr
葭	trse
葺	trsj
蕺	trji
菋	trjd
蘄	trjl
葭	trye
莡	tryo
𦬊	tru
茣	trvk
苠	trvp
荶	tron
蓶	trog
敬	trok
雚	trrg
萼	trrs
蕚	trrs
蕇	trrj
虈	trrr
䓃	trau
莒	trhr
昔	ta
莭	tail
蔇	taiu
萌	tab
萺	tabu
蒀	tabt
菛	tan
蕑	tanb
藺	tang
蘭	tanw
蔅	tanv
蕄	tanp
蔄	tanr
䕡	tanr
蕳	tana
蒔	tagi
莫	tak
蟇	taki
𦻒	taki
幕	takb
墓	takg
募	taks
摹	takq
驀	takf
慕	takp
謩	takr
暮	taka
菒	tad
皵	tadhe
剒	taln
𦴤	talk
蔓	tawe
蕞	tase
草	taj
芭	tau
茛	tav
葃	taos
葛	tapv
菎	tapp
䓪	taph
菖	taa
蕌	taaa
斮	tahml
葃	tahs
葿	tahu
鵲	tahaf
蘬	thmb
芹	thml
𦭐	thmy
茩	thmr
蔵	this
苽	thio
薁	thbk
首	thbu
虋	thbh
芃	thni
葻	thni
䔧	thnd
芟	thne
𦯀	thg
薫	thgf
薰	thgf
芺	thk
蕎	thkb
菾	thkp
蒩	thdm
萟	thdi
蕱	thdb
莉	thdn
𦻓	thdg
䔉	thdd
蕃	thdw
薐	thde
莠	thds
萪	thdj
萩	thdf
蘓	thdf
萎	thdv
藒	thdv
萂	thdr
萫	thda
蕛	thdh
菞	thdh
萭	thlb
蘌	thlf
𦲽	thlo
萆	thwj
蔥	thwp
蓖	thwp
莑	thej
苳	they
茖	ther
芦	ths
萹	thsb
菺	thsb
薂	thsk
䓞	thsk
蒑	thse
蔰	thsu
芊	thj
菙	thjm
董	thjg
糵	thjd
茱	thjd
蘖	thjd
葮	thje
躠	thjo
䒷	thjr
苼	thqm
莪	thqi
芼	thqu
苵	thqo
𦶢	thyn
蒰	thye
苸	thfd
蘍	thfs
蒐	thui
蒠	thup
蘶	thvi
䒢	thvl
蔸	thvu
苽	thvo
芪	thvp
蘈	thvc
荇	thon
葕	thon
𦸇	thon
蘅	thon
薇	thok
𦱿	thok
𧃸	thok
藢	thok
蒣	thod
蓹	thol
蕧	thoe
葎	thoq
蓯	thoo
蓰	thoo
蓗	thoo
蓏	thoo
茋	thpm
茚	thpl
蓃	thxe
蕮	thxf
萖	thxu
萸	thxo
藇	thxc
藰	thcn
蒒	thrb
薛	thrj
苩	tha
菂	thai
葟	thag
葲	thae
𧄦	thae
蔦	thaf
蘤	thaf
葩	thau
藠	thaa
蔾	thhd
茆	thhl
𦺄	thhl
萆	thhl
蒥	thhw
藜	thhe
𦺙	thhq
蕦	thhc
鶜	thhaf
井	tt
并	tt
卌	tt
並	ttm
苷	ttm
頩	ttmbc
𦳑	ttmd
葚	ttmv
瓶	ttmvn
萁	ttmc
丼	tti
葥	ttbn
郱	ttnl
鄷	ttnl
艶	ttnau
艵	ttnau
坓	ttg
薱	ttgi
冓	ttgb
蓔	ttgf
葁	ttgv
蓳	ttlm
䔿	ttwi
蠲	ttwli
蓸	ttwa
汬	tte
剏	ttsk
刱	ttshi
剙	ttshi
蘜	ttjd
龩	ttjl
𦭵	ttq
蒫	ttqm
蒴	ttub
蘛	ttvb
蒹	ttxc
並	ttc
豑	ttcnh
蘣	ttcg
𦸀	ttcg
蘳	ttcg
䔮	ttcl
藄	ttcf
鷁	tthaf
鵧	tthaf
荓	ttt
